text	label
UNkanyiso nomkhankaso wokwehlisa isisindo	Ezokungcebeleka
Abaphathi bakaPitso kabaneme ngesixoliso seSundowns	Ezemidlalo
Amathe abuyele kwasifuba kushada osaziwayo	Ezokungcebeleka
ULarsen ugxile kokuhlukile	Ezemidlalo
Aseqalile amakhonsathi eJoyous Celebration	Ezokungcebeleka
‘UMakhubela ngeke lumone udumo’	Ezemidlalo
UKhuzani ufuna ubufakazi kombangisa ngesiqholo	Ezokungcebeleka
Umaskanda uvulelwe icala ngowoKhozi FM	Ezokungcebeleka
Umthwalo weChampions League kuMessi wePSG	Ezemidlalo
IMaritzburg ngeke ikujahe ukuvala isikhala somgadli	Ezemidlalo
UKhuzani uselufake kubameli olwemali	Ezokungcebeleka
Ithuba lokubuka umdlalo iLegacy	Ezokungcebeleka
Aluvalwe uhlelo lukaJub Jub Uyajola9/9	Imibono
IBanyana nephupho leyoMhlaba	Ezemidlalo
I-NFP isalidinga ithuba lokukhombisa ubuqotho	Imibono
Ukhuza ibuya uJerry Maake kwiThe Queen	Ezokungcebeleka
Odayisa umqombhothi akanandaba nabamgxekayo	Intandokazi
UMbau uxwayisa ngokuziyebula isikhumba	Ezokungcebeleka
Bahloniphe uMlambo-Ngcuka ngengoma	Ezokungcebeleka
UsekwiVuma futhi uSefatsa	Ezokungcebeleka
OweLeopards usongela abanga isicoco sePSL	Ezemidlalo
UDJ Bongz neseluleko kumaciko	Ezokungcebeleka
Amawele aseThekwini ohlelweni ku-e.tv	Ezokungcebeleka
Ibalulekile i-sign language emsakazweni	Ezokungcebeleka
Ubonga ukuqokwa kumaCrown yize engawinanga	Ezokungcebeleka
IGcokama lisolwa ngokuhamba libhabhabala	Ezokungcebeleka
Kuswele ozogadla koDJ bexabana	Ezokungcebeleka
Kuzobe kuphithizela osaziwayo emshadweni womlingisi	Ezokungcebeleka
Kuqoshwa isizini entsha yoThando Lodumo	Ezokungcebeleka
Usuthu lukhombe uCamaldine Abraw afike ngayo	Ezemidlalo
UThuso Phala uchaza ngomdanso wakhe	Ezokungcebeleka
ICell C Sharks izigwazele ibhece kwiSunwolves	Ezemidlalo
Ithuba lokuqeda ubunzima kwezamafilimu	Ezokungcebeleka
UChippa akazisoli ngokuxosha abaqeqeshi	Ezemidlalo
UPitso ukhonjwa eGibhithe	Ezemidlalo
UDanger noLvovo bakhiphe i-albhamu ngokuhlanganyela	Ezokungcebeleka
UMicho ukhala ngababhacazile	Ezemidlalo
Kwakunzima babekezela manje sebevelele emikhakheni ehlukene	Intandokazi
Ususe umsindo umdlali weChiefs ngokufuna ukudlala	Ezemidlalo
Zakhele isitayela sakho ngeduku	Intandokazi
Iziqephu zeLockdown sezizobukwa kwiShowmax	Ezokungcebeleka
Kubhekwe bathathe umqhele kuPogba eRussia	Ezemidlalo
Isikhulu sichaza ngokuxoshwa kwaso kwelePSL	Ezemidlalo
UMboweni umelwe wumqansa wokwenza izwe lithembeke	Imibono
Imfihlo ngoNtshangase kwiChiefs	Ezemidlalo
URalani uxwayisa ngokuqiniswa konyawo	Ezemidlalo
Ushone elindwe wumsebenzi umlingisi	Ezokungcebeleka
UThandeka ukhuza ibuya kwezokulingisa ngeHostela	Ezokungcebeleka
IChiefs isiphumele obala ngoweStars	Ezemidlalo
OwoSuthu uvule amaphakethe ngabadlali abazofunwa uMcCarthy	Ezemidlalo
Uzicelele ukukhululwa uBartlett kwiGalaxy	Ezemidlalo
Osindisiwe ulingisa eyokuba ngumqwayizi	Ezokungcebeleka
USuthu luhlomele injabulo ezayo	Ezemidlalo
Kushiye omunye umlingisi kuZalo	Ezokungcebeleka
Usinde kukubi ebanjwe yiCovid-19	Ezokungcebeleka
IDurban Gen isayibambe ngakho kodwa...	Ezokungcebeleka
Inkantolo igunyaze ukuboshwa kukaMampintsha noBabes Wodumo	Ezokungcebeleka
Abapheze ukugwazisa kolayini aboMnyango wezaseKhaya	Imibono
Kuyambhedela uR. Kelly	Ezokungcebeleka
Ngeke ngihlukane noRingo: Sne	Ezokungcebeleka
UMaster KG ubonge abalandeli ehlabana ngeye-MTV	Ezokungcebeleka
UHunt usanethemba ngesicoco	Ezemidlalo
Olunye udume kwiChiefs kulimala isibabuli	Ezemidlalo
UBabes uchaza ngevideo abonakale kuyo ekhala ubumayemaye ebanjwe amaphoyisa	Ezokungcebeleka
OwoSuthu uzolwela indawo kwelesizwe	Ezemidlalo
UCassper usehlela ukugcwalisa iMabhida	Ezokungcebeleka
UDanny Glover nesexwayiso kubenzi bamafilimu baseMzansi	Ezokungcebeleka
IChiefs ixwayisa umphakathi ngabaqola ngegama layo	Ezemidlalo
ITheku lizosingatha ingqungquthela yeForbes	Intandokazi
AbeBucs nelinye ithambo lokugiya	Ezemidlalo
Ukuphindile lokho uCaster	Ezemidlalo
Selukubameli olukaSomizi  noMohale	Ezokungcebeleka
[IMIBONO] Bengifisa ake ahlupheke u-Eymael	Ezemidlalo
‘Asiqondi ukuthi sisale kanjani kwi-Afcon’	Ezemidlalo
IChiefs igaqele owaduma kwiBucs	Ezemidlalo
UBrooke weBold uzobonakala kwiSidingo	Ezokungcebeleka
I-Japan iziwolele amaphuzu amathathu kwiColombia	Ezemidlalo
Abedokwe lendlala benza umsebenzi wethongo udicileke phansi	Imibono
Uphrojusa kaDuncan uphawulwa ngokuchithwa kweSikelela kwiYFM	Ezokungcebeleka
Usike ukhasi uKgatlana kowe-CAF	Ezemidlalo
Iwole izindondo ezinhlanu iThe River	Ezokungcebeleka
Ihobeleni Inkatha ngodaba lukadoti eThekwini?	Imibono
Ukushiya kukaMhlongo kunika uMpontshane ithuba	Ezemidlalo
IGalaxy yandisele umqeqeshi weSwallows izinkinga	Ezemidlalo
Wayebalekela ukuwasha izitsha ngebhola oweBanyana	Ezemidlalo
IPirates ivule igebe esicongweni se-log	Ezemidlalo
OweMbewu ukhulelise uzakwabo	Ezokungcebeleka
Ushiye isigubhukane oweSA FM	Ezokungcebeleka
U-Da Gama ugxeka indlela obekuphethwe ngayo iPlatinum	Ezemidlalo
UManyama ubalisa ngesikweleti seChiefs	Ezemidlalo
Asiwuboni umsebenzi owenziwa yiNkatha eNquthu	Imibono
Uzojabulisa abalandeli   ngama-video ezingoma zakhe	Ezokungcebeleka
UMaMkhize uchitha eyokugxambukela othandweni luka-Andile noSithelo	Ezokungcebeleka
UProfessor ucikwa ukushaywa ngesithende	Ezokungcebeleka
ISharks izinuka amakhwapha ngokuhlulwa kulandelana	Ezemidlalo
Ingwazi yeBafana ibanike ithuba kwiPSL	Ezemidlalo
Izinguquko zeMini Countryman ziyenza ihehe	Ezezimoto
Kusemahlombe ethu ukufukula iqembu – Mutizwa	Ezemidlalo
OweKings ubonga ngokwesekwa	Ezemidlalo
Ngane yami, uyimpendulo yemithandazo kagogo	Ezokungcebeleka
Ubamba izigelekeqe esemoyeni uKabini	Intandokazi
I-Arrows isibambe umoya ngePolokwane	Ezemidlalo
AmaTuks azogadla ngowaduma kwiChiefs	Ezemidlalo
Akasadlaliswa ofunwa yiPirates neSundowns	Ezemidlalo
‘Sizolwa kuze kube sekugcineni’	Ezemidlalo
Uyancomeka umsebenzi kaMthiyane kwiGagasi	Imibono
Baxhase owesifazane onepulazi	Intandokazi
I-Arrows ishovele iFree State obishini	Ezemidlalo
Uhubhuza amanga uMbali: Black Coffee	Ezokungcebeleka
Udalule isehlo sokudlwengulwa owoKhozi	Ezokungcebeleka
U-Sis J usebhala izingoma zikamaskandi	Ezokungcebeleka
AmaZulu neDowns baqhathiwe kweyeCaf	Ezemidlalo
Ziyanda izinhlelo zaphesheya eziza kuleli	Ezokungcebeleka
Kuhlelwe umcimbi ozohlomisa intsha ngolwazi eludingayo	Ezokungcebeleka
Kuminciwe uTau elimala kuyiwa kwi-Afcon	Ezemidlalo
USomizi udalula imfihlo ngezifo ezimhlasele	Ezokungcebeleka
Ukhwele wadilika uMcG kwabagxeka uhlelo lwakhe	Ezokungcebeleka
Izoboshelwa izacile kwiWits ibhekene neDowns	Ezemidlalo
UMessi uthubeni lokuqeda ishobolo lokudla  izicoco	Ezemidlalo
OweRoyal AM uzishaya isifuba ngokuphinda Amakhosi	Ezemidlalo
Imfundo yethu kumele ibe nobunkipha bukoloni	Imibono
IChiefs izolwela igoli eMorocco	Ezemidlalo
Ukhale ngabadlali abalimele kudliwa iqembu lakhe	Ezemidlalo
Uzofihlwa ngempelasonto uMenzi	Ezokungcebeleka
UKekana uchazwa wukuzinikela kukaBilliat	Ezemidlalo
OweBafana uthole iqembu elisha eDenmark	Ezemidlalo
‘IReal Kings isidayiselwe u-Andile Mpisane’	Ezemidlalo
USilva ukhwele wadilika kuPitso	Ezemidlalo
Uzoba nohlelo lwakhe lokupheka kwiTV	Ezokungcebeleka
IPirates isithembe ukuvuka ngoSuthu	Ezemidlalo
Ifilimu entsha yakuleli kwiNetflix	Ezokungcebeleka
UNowa naye bamhleka bethi ugugile ebaxwayisa	Imibono
'IChiefs izoqhubeka nokuba yithofi kowomkhaya baseSoweto'	Ezemidlalo
Kuvalwa izitolo zomculo iMusica	Ezokungcebeleka
UNtseki uselinde uhulumeni ukumemezela eseBafana	Ezemidlalo
Awucaci kahle umnyakazo owenziwe nguKomphela	Imibono
Ubematasa nohlelo olusha lwethelevishini owaduma kuKhozi FM	Ezokungcebeleka
Ibohlololo koweBucs neDowns	Ezemidlalo
Isinohlelo kwiVuma ingoduso kaZuma	Ezokungcebeleka
Ubuyisa ithemba ngengoma uMtee	Ezokungcebeleka
I-TUT inciphise igebe leSundowns Ladies kwi-Super League	Ezemidlalo
‘UZweli’ usesishiya unomphela Isibaya	Ezokungcebeleka
IPirates ihluleke wukunqoba izitha zingasaphelele	Ezemidlalo
UTovey utusa umlando wabakuleli kwesokuqeqesha iBafana	Ezemidlalo
USindi Dlathu usengumdidiyeli	Ezokungcebeleka
UKhuzani noNgizwe babanga ububi	Ezokungcebeleka
Usizwe abalandeli etinyelwa kuTwitter uMiss SA	Ezokungcebeleka
ISundowns isibheke amagalelo kaSirino	Ezemidlalo
Ushintshe isigqi somculo uBlack Coffee	Ezokungcebeleka
UDolly ubheke eminye imiklomelo eNaturena	Ezemidlalo
Unengwe yisenzo sesitobha sakhe	Ezemidlalo
Ungene kowamapiano umlingisi weThe Queen	Ezokungcebeleka
Igazi lomuntu liyakhala emhlabathini	Imibono
Abamele iKZN kokaMiss Empress SA	Intandokazi
Bathembisa ulozolo kwiFamily Secrets	Ezokungcebeleka
Akuphele ngokuhlukunyezwa kwabantu besifazane	Imibono
Singase sivalwe yisibabuli somgadli esikaCastro kwiDowns	Ezemidlalo
UBen 10 wenza into yamehlo kwi-Amiens	Ezemidlalo
Amathiphu okudweba amashiya ukuze abukeke ngendlela efanele	Ezokungcebeleka
Wenzelwe iphathi engazi uDJ Happy Gal	Ezokungcebeleka
Ezothando: Nasemjolweni kukhona labo esingabalokothi	Ezokungcebeleka
OweCameroon akawuvali umlomo bebuya nethusi	Ezemidlalo
Sekuqubuke umsindo ngemali yeGobisiqolo	Ezokungcebeleka
UMiddendorp akaliphonsile ithawula ngokuvika izembe	Ezemidlalo
UMasutha ubalisa ngokujika nelanga engasebenzi	Ezemidlalo
Uhlabane ngomsebenzi kwiCeltic uKomphela	Ezemidlalo
Ukuzala kakhulu yikho okubangela indlala ezweni	Imibono
UHunt uzifake emlandweni enqoba iTelkom eMagogo	Ezemidlalo
UPitso ukhale ngabadlali abalimele	Ezemidlalo
[IMIBONO]Udayiswe abaphathi bakhe abathanda imali uFadlu Davids	Ezemidlalo
UsekwiGomora ozakhele igama kuZalo	Ezokungcebeleka
I-Bucs izoqeda ukhondolo lwendawo yesibili	Ezemidlalo
Uthole inkontileka kwiTeam of Choice	Ezemidlalo
Ingqayizivele yethuba kuCream	Ezemidlalo
‘Izimo ezinzima zikwenza uqine’	Intandokazi
Kutholane phezulu uKhuzani neGcokama emcimbini	Ezokungcebeleka
Ziyawushaya kuKelly Khumalo nomrepha?	Ezokungcebeleka
UNdlovu ubelwela abekholwaukuthi kungokwakhe	Imibono
'Akukhona esiteji la' - iMantshi kuTipcee	Ezokungcebeleka
Kwehle izikhulu eGoli ngezinkinga zoKhozi	Ezokungcebeleka
Okuhloswe wuSihlalo webhodi  loMgeni Water	Intandokazi
Kuzovovana inkani amaciko  kowokuqhakambisa amasiko	Ezokungcebeleka
ISafa nezinhlelo ngazonyukela kwiGladAfrica	Ezemidlalo
OweBanyana uchaza ngesinqumo sokuqoka elaseChina	Ezemidlalo
Ufuna ukukhula ekulingiseni oshiya kwiGenerations	Ezokungcebeleka
UNgcobo ugabe ngamava asekuhambeni emdlalweni weSimba	Ezemidlalo
’Nami uJub Jub wangidlwengula’ - Masechaba	Ezokungcebeleka
Abantu kufanele bayisabe into okuthiwa wukuthwasa	Imibono
Amandla e-Audi SQ7 ayenza ihambe kalula	Ezezimoto
IMoja Love ichithe uYaya ngenxa yempakamo	Ezokungcebeleka
Uchithe amahlebezi elobolo likaR1mln	Ezokungcebeleka
Ithuba laphesheya kubadlali boSuthu	Ezemidlalo
ULunga uyakweshwama ukumataniswa neSundowns	Ezemidlalo
Ufisa ukukhula emkhakheni wezindaba uMancane	Ezokungcebeleka
Unqotshwe isifo sikashukela uMshoza	Ezokungcebeleka
Usomabhizinisi ukhala ezimathonsi ngokushona ngokuzuma kukaMshoza	Ezokungcebeleka
Ibuya ngonyawo olusha iBlood and Water	Ezokungcebeleka
Ziphoselwe kwiGladAfrica kwethulwa umacekeceke ohamba nezigidi	Ezemidlalo
Isibonakala kwi-Generations intokazi esencane	Ezokungcebeleka
UNgcongca ubona umqansa ngeCAF	Ezemidlalo
Kuzohlonishwa Ihhashelimhlophe kumaSapma	Ezokungcebeleka
Kulamule uPogba iFrance iguqisa i-Australia ebibathwalise kanzima	Ezemidlalo
Libuyile ithemba kwiPirates ebheke kwiConfed Cup	Ezemidlalo
Usebenzisa ithalente lakhe ongenasandla	Ezokungcebeleka
Ezothando: Kubathatha isikhathi esingakanani abesifazane ukufinyelela kuvuthondaba?	Ezokungcebeleka
UMotaung akanavalo ngoCastro	Ezemidlalo
Kumnyama ngonozinti waseKZN kweZimnyama	Ezemidlalo
Musani ukudlala ngathi sidinga usizo ngokushesha	Imibono
Injini yoSuthu isiwubheke ngabomvu oweMazembe yodumo kwiCaf	Ezemidlalo
‘UKhenyeza uxoshwe yinkece kwiMaritzburg’	Ezemidlalo
UDuncan uzwakalise ukushaqeka umsakazo uchitha iSikelela	Ezokungcebeleka
Ingene ehlazweni inkakha yeshashalazi 'ikhulelisa' intombi	Ezokungcebeleka
Ukhala ngenkohlakalo kumaSAMA umrepha	Ezokungcebeleka
Izoqhathwa ngoLwesibili iBafana kweyokuhlungela iWorld Cup	Ezemidlalo
Ikhefu elibalulekile kuTinkler neqembu aliphekayo	Ezemidlalo
Kuqhubeka izinhlelo ngefilimu kaMaBrrr ebivinjwa	Ezokungcebeleka
Akawazi umnyango wesonto uManyama	Ezemidlalo
UHunt enkingeni yabadlali abasha	Ezemidlalo
IChippa isinomqeqeshi omusha	Ezemidlalo
Kugqame isidingo seVAR iDowns ibuyisa umgqigqo	Ezemidlalo
Ukuvalwa kwezwe kumvulele amathuba	Ezokungcebeleka
Owelesizwe ufike wadidwa wulwimi eqenjini elisha	Ezemidlalo
UBaxter utusa uTau ngokumelana nezingqinamba	Ezemidlalo
U-Emtee useyishiyile i-Ambitiouz Entertainment	Ezokungcebeleka
Bathukile kudlula emhlabeni uDJ osafufusa	Ezokungcebeleka
Udalula okumenze washiya i-ECR	Ezokungcebeleka
Osomathuba kabayekele ukuthembisa ngomhlaba ongekho	Imibono
Ukhale ngokulimala kwezethenjwa uLarsen	Ezemidlalo
Umbhobho woKhozi FM usuyimali kubaculi	Ezokungcebeleka
Izindaba ezimnandi ngoWayde	Ezemidlalo
Uyakhula kwezamabhizinisi osebenza ngezandla	Intandokazi
Kumele ziphunyuzwe izinkophe zokufakelwa	Intandokazi
Injabulo uKwesta ebopha ifindo lomshado	Ezokungcebeleka
Babambe umoya ngesinqumo ngamaSevens	Ezemidlalo
AmaBlitzbokke abheke ukuqhubeka nomgqigqo	Ezemidlalo
Usesibhedlela umdlali weChiefs	Ezemidlalo
Kusolwa ubunqonqela kusihlalo ngokubuya kukaNgema kwiChippa	Ezemidlalo
Isikhalo sabalaleli ngeZwi LoMzansi	Ezokungcebeleka
IDowns iqinise umbango nge-Arrows	Ezemidlalo
Umdlalo wakuleli uqophe umlando e-USA	Ezokungcebeleka
Ibuya nomculo omusha iDestruction Boyz	Ezokungcebeleka
ISharks ifuna ukubuyisa isithunzi e-Australia	Ezemidlalo
Uvuma izinsizwa ezimnyama kwikhilikithi	Ezemidlalo
Bamincile ngesinqumo sePSL ngolweThanda	Ezemidlalo
Izinguquko kwiVW Tiguan	Ezezimoto
Isexwayiso ngogwayi iHubbly Bubbly	Ezokungcebeleka
Injabulo ngendawo ephambili efilimini	Ezokungcebeleka
Ubungoma abumvimbi ekuculeni amapiano	Ezokungcebeleka
Umaskanda uhleka usulu eyokuthwala	Ezokungcebeleka
Bazikhalele kuhulumeni kungcwatshwa uMenzi	Ezokungcebeleka
IBafana isahamba kahle endleleni ebheke kweyoMhlaba eQatar	Ezemidlalo
OwamaProteas uyazigqaja ngokuhlabana	Ezemidlalo
UBabes ucacisa ngoBrilliant Khuzwayo	Ezokungcebeleka
Akuqiniswe ezokuphepha emanyuvesi	Imibono
Kugxekwa inyanga ‘ewinise’ uMroza	Ezokungcebeleka
Okusize iChiefs yathola uNgcobo weZinyoni	Ezemidlalo
Ukuqhuzuka kwe-Arrows ayiboni  kuzoyikhipha ekungeneni kwiTop 8	Ezemidlalo
Kufezeke iphupho kuDJ engena kuKhozi FM	Ezokungcebeleka
Usathuthumela uvalo uDJ odunwe imoto	Ezokungcebeleka
UKhuzani uzobonakala eHostela eziqeshini ezintsha zalo mdlalo	Ezokungcebeleka
Ukhiphe umucu umlingisi weSibaya	Ezokungcebeleka
'Umculo uyangiphilisa'	Ezokungcebeleka
Kubuya abebelimele kwi-Arrows	Ezemidlalo
Ayikho ezithebeni eyokufunwa kukaSithebe yiDowns	Ezemidlalo
UYeye akazimisele ngokuwaphanyeka	Ezemidlalo
Uqale kahle unyaka embonini yezimoto	Ezezimoto
Kubaqinisela uthando lwabo ukusebenza ndawonye	Ezokungcebeleka
Kuzohlonishwa ingqalabutho yomculo wokholo kumaSama	Ezokungcebeleka
Badumele kuhoxa umculi kuma-Idols	Ezokungcebeleka
Asefuna idivosi amawele ashada nomyeni oyedwa	Ezokungcebeleka
Umsakazi uthi akaziboni eshada nonengane yomunye umuntu	Ezokungcebeleka
OweGomora usethi khumu ekulingiseni	Ezokungcebeleka
Uthembisa lukhulu okhiphe iDomoroza	Ezokungcebeleka
Ikhuza ibuya iCurrie Cup kule mpelasonto	Ezemidlalo
Usola abagxambukela ebudlelwaneni bakhe uLaChonco	Ezokungcebeleka
Uyancomeka umsebenzi wezomphakathi	Ezokungcebeleka
Umbango wobuholi udicilela phansi isithunzi sobuNazaretha	Imibono
IChiefs neDowns empini yesibabuli somgadli	Ezemidlalo
Uzomiswa isonto uPhat Joe	Ezokungcebeleka
UMatlaba ukhethe iLeopards	Ezemidlalo
Bajabulela ukuqala namaqembu anzima	Ezemidlalo
‘Angiyibhekise kumuntu ingoma’	Ezokungcebeleka
Banethalente elikhulu  abemisakazo yomphakathi	Ezokungcebeleka
Luzolwela ukubuyisa isithunzi uSuthu	Ezemidlalo
UmkaNcwane uchaza ngokubhala incwadi ngempilo yabo	Intandokazi
Ukudayiselana kweThanda noSuthu sekukuPSL	Ezemidlalo
I First Man ngeyabathanda ukwazi ngomhlaba	Ezokungcebeleka
USthandwa uzobonakala kwiDurban Gen	Ezokungcebeleka
UZimdollar uzobhekana nodadewabo kaNgizwe enkantolo	Ezokungcebeleka
Uqinisa idolo uzakwabo oweBucs	Ezemidlalo
Umlingisi uziveze enqunu washubisa umdlalo	Ezokungcebeleka
Asenziwa ngenye indlela ama-baby shower	Intandokazi
Abantu bazojabula besezimotweni	Ezokungcebeleka
Sizophonselwa inselelo isinqumo esibandlulula uCaster Semenya	Ezemidlalo
Uxwayisa ngesimo semidlalo esingajwayelekile	Ezemidlalo
Zimhambela kahle uGogo Skhotheni	Ezokungcebeleka
Uya enkantolo umqeqeshi weSharks ngemali	Ezemidlalo
IPirates isayinisa ingenamqeqeshi	Ezemidlalo
Bazovela enkantolo oBabes noTipcee	Ezokungcebeleka
I-Maritzburg izicabele indlela iphumelela	Ezemidlalo
Usidayisile isizwe Magaye, walahla nomsamo wakho	Imibono
Uphupha ngePirates owe-Arrows	Ezemidlalo
Udonsa kanzima ejezini owaduma kwiBafana	Ezemidlalo
UMakhadzi uqokwe okokuqala kowezindondo	Ezokungcebeleka
ULondi London uzimisele ngokukhulu kwithelevishini	Ezokungcebeleka
Kuzohlonishwa amaciko aKwaZulu-Natal	Ezokungcebeleka
Abantu bafuna udumo ngokuphawula ngoZuma	Imibono
UKhuzani uhlonipha iSilo ngeculo eligqugquzela imfundo	Ezokungcebeleka
UTinkler uzishaya isifuba ngakwenzele iChippa United	Ezemidlalo
USangweni ujabule ebuyela kwiDStv Premiership	Ezemidlalo
Abagijimi benzelwe phansi wumdonsiswano	Ezemidlalo
USono ’uzobulala’ kwasani ngabadlali abasha	Ezemidlalo
Kukhunjulwe uMandoza ngosuku lwakhe lokuzalwa	Ezokungcebeleka
Amaciko abopha iSABC ngesikweletu somculo	Ezokungcebeleka
Buka: UZodwa Wabantu uhlinzwe odokotela 'evuselela' inanazi	Ezokungcebeleka
Usaphupha ngokusinda ezembeni owePolokwane	Ezemidlalo
Iqembu le-netball liwuvule kahle owase-Afrika	Ezemidlalo
UKhumalo ufuna ukuvala iComrades ngegolide	Ezemidlalo
'UMabena ukhuliseabasakazi abaningi'	Ezokungcebeleka
Kuzosiphuka izidindi  koweDowns ne-Al Hilal	Ezemidlalo
UNaima Kay ufuna ukuya kude nomculo wakhe	Ezokungcebeleka
Iyavuthwa ekaZimdollar ebheke esithenjini	Ezokungcebeleka
I-SABC icacisa ngezinsolo ze-payola	Ezokungcebeleka
ULarsen ufuna babuyise izinduku	Ezemidlalo
IPirates ngeke ilibone elidlalayo kwiSiwelele, kusho uTsutsulupa	Ezemidlalo
USkolopad uthembise ukuyeka ukubhushuzela uma ningenza lokhu...	Ezokungcebeleka
Usazimisele ngomcimbi wokugcwalisa iMabhida	Ezokungcebeleka
Bathi izwi likaPitso ngeke liwele phansi	Ezemidlalo
IGagasi FM nemigubho yeminyaka engu-15	Ezokungcebeleka
Zimhambela kahle oweFreshlyground	Ezokungcebeleka
U-Hunt ubonge abesebenza nabo kwiWits	Ezemidlalo
ISafa ivule izandla ekusingatheni i-Afcon	Ezemidlalo
I-BMW 4 Series Coupe iyagqama	Ezezimoto
UMseleku uxwayisa  abantu  ngemali	Ezokungcebeleka
UKumalo ulibona limfiliba ithuba lokuqokwa kwiBafana	Ezemidlalo
UKomphela uvuse abeDowns ngomkhuleko	Ezemidlalo
Uzizwa ezelwe kabusha ngethuba lokuphinde adlale	Ezemidlalo
UNtseki uqoka abadlali afunzwabona ngabanye abantu	Imibono
‘Kumele sithole wonke amaphuzu emidlalo esele’	Ezemidlalo
Uxwayisa awe-PSL ngeSundowns	Ezemidlalo
Izimanga zikaTau eBelgium zizosiza iBafana e-Egypt	Ezemidlalo
UMchunu weSharks ulambele ijezi lamaBhokobhoko	Ezemidlalo
Umshushisi ozoqashwa yiPSL uzofica inqwaba yamacala angaphelile	Ezemidlalo
IChiefs ibuyele ekhaya ishwiba izandla	Ezemidlalo
EZEMISAKAZO: Kuhle okwenziwe uMo noMasechaba, kodwa...	Ezokungcebeleka
UMicho akabasoli abadlali bakhe	Ezemidlalo
Waqala ngoR1 200 osenenkampani ekhiqiza izinto zokuhlanza	Intandokazi
Akafuni ukucacisa ngokulungela eyokusonga iligi	Ezemidlalo
Kuyasixaka lokhu okwenzeka manje kwi-ANC	Imibono
Imenenja kaMlindo isola uDJ Maphorisa ngobuqili	Ezokungcebeleka
Ubesemanqika ukulingisa owoZalo	Ezokungcebeleka
Kugwazwe kwabulawa ibhokisa laseKZN	Ezemidlalo
UJohnson akumkhathazi ukuthi kunabamsongelayo	Ezemidlalo
Uthathe isicoco emncintiswaneni wokupheka	Intandokazi
Uthembisa lukhulu umqeqeshi weChiefs	Ezemidlalo
Sicela ama-laptop ne-data esathenjiswa kona emaTVET College	Imibono
Luthuthela kuMzansi Magic uhlelo lukaPhat Joe	Ezokungcebeleka
Kumele siwuwine lo mdlalo - Mbambo	Ezemidlalo
Ungowesifazane wokuqala ezindizeni zempi	Intandokazi
Kugqame abaseKZN kumaSama	Ezokungcebeleka
UNcikazi unethemba lokuqokwa  kwabakhe kwiBafana	Ezemidlalo
Inkulumo kaKhumalo ilumele kwiBaroka	Ezemidlalo
Bazoshiyelana inkundla noWizkid abakuleli	Ezokungcebeleka
IBucs izongena koweMTN8 iphekekile	Ezemidlalo
Umlingisi ucacisa ngezinsolo zokuhlukumeza uzakwabo ngocansi emdlalweni	Ezokungcebeleka
UZuma uthi impi izoba senkabeni yenkundla koweMTN8	Ezemidlalo
OwoSuthu usenethemba lokunqoba iMazembe	Ezemidlalo
U-Ekstein obemataniswa neBucs uvumbuke e-Europe	Ezemidlalo
UHunt ukhala ngokulinyalelwa nayizethenjwa	Ezemidlalo
Kuhlonishwa olwela abanebala elimhlophe	Ezokungcebeleka
IPremier Soccer League izokhokha izikweletu zanyakenye	Ezemidlalo
I-Wits iphuce iChiefs iqatha emlonyeni	Ezemidlalo
Ukhihla isililo ngokushiya kukaMoeneeb  kwiWits	Ezemidlalo
UDJ unxusa uhulumeni ukuthi alekelele amaciko	Ezokungcebeleka
Izinongo koweChiefs neCeltic	Ezemidlalo
Ifilimu ngokuhlukunyezwa kwembokodo eJohn Voster	Intandokazi
UZodwa Wabantu uhlanyiswa yisoka elisha	Ezokungcebeleka
Kuyaphela ngohlelo lukaKelly	Ezokungcebeleka
UZinnbauer usola abadlali ngokuzongela oweCity	Ezemidlalo
Owaduma kwiTsotsi uthembisa lukhulu oluza neThe River	Ezokungcebeleka
UMngqithi noMokwena bazobambisana kwiDowns	Ezemidlalo
Injabulo uBenni enqoba isicoco sakhe sokuqala	Ezemidlalo
Bahlukene phakathi ngesenzo sikaDJ Sbu ekhangisa iMoFaya	Ezokungcebeleka
UDladla ugaqelwe yiPirates	Ezemidlalo
IChiefs ikhombe indlela obengumqondisi	Ezemidlalo
USomizi unqatshelwe ukuya eZambia	Ezokungcebeleka
Uqola abantu esebenzisa igama leqembu	Ezemidlalo
Bagqoke izingubo behlonipha uDkt Sindi Van Zyl	Ezokungcebeleka
USal ukhule limthwalisa kanzima igama likaMasekela	Ezokungcebeleka
UTau uthushuke lapho engalindelwe khona	Ezemidlalo
Lungene kwelinye iqophelo olukaBuhle Mkhwanazi ongadlali	Ezemidlalo
UNcikazi ujabulela ukuqashwa kukaKhenyeza abe yiphini lomqeqeshi	Ezemidlalo
IBlaq Diamond iwine indondo eNigeria	Ezokungcebeleka
IMIBONO: UKhuzani makayeke ukunaka amavukana	Ezokungcebeleka
ULebese nesifiso sokujabulisa i-United ithole amaphuzu	Ezemidlalo
Ulengela eweni umshado wabokholo	Ezokungcebeleka
IMercedes-Benz ingenisa ngezikagesi kuleli	Ezezimoto
UCassper ulobole isingqazu saseThekwini	Ezokungcebeleka
Bazidonsele amanzi ngomsele bezibiza ngoBonnie & Clyde	Ezokungcebeleka
Isethembiso sikaMicho ngezindebe	Ezemidlalo
Bamjikijele ngebhodlela likabhiya enandisa uTira	Ezokungcebeleka
Iyinyama kubathengi iVW Polo Vivo	Ezezimoto
Uthukile ethola izitifiketi ngomculo wakhe uMlindo	Ezokungcebeleka
URhoo ukhuza abakuleli ngokonela uTau eqenjini lakhe	Ezemidlalo
Bazozitika ngomculo kumaSatma Awards namhlanje	Ezokungcebeleka
Abantu abalandele imigomo ukuze silunqobe ukhuvethe	Imibono
UClinton akazenyezi ngokuqeqesha kwiGladAfrica	Ezemidlalo
Isithela izithelo imikhankaso yenyuvesi nabamatekisi	Intandokazi
OweBucs uvuma eyokuvuza ngasemuva	Ezemidlalo
EzikaBenni ethubeni lesicoco	Ezemidlalo
UZinnbauer ubheke ezinye izindebe nePirates	Ezemidlalo
UKaizer wenza iphutha eqoka uBobby	Imibono
Amehlo athe njo ku-Amanda Black noBabes kumaMMA's	Ezokungcebeleka
Ibangwa amaqembu amathathu injini yakuleli egijima ePortugal	Ezemidlalo
'Kungamanga ukuthi ubuholi bebandla buhamba ngobukhosana'	Imibono
UMngqithi ufuna abadlali benyuse amasokisi	Ezemidlalo
AbeChiefs bakhombise izinguquko ngeCarling	Ezemidlalo
UNozibusiso uza nohlelo oluzosiza izithandani	Ezokungcebeleka
UKgatlana ubuyisa ithemba ngelabesifazane	Ezemidlalo
U-Anele Mdoda emcimbini ophambili eHollywood	Ezokungcebeleka
Awubala amadoda amathathu ngosuku kowesifazane: Rami	Ezokungcebeleka
UMpintsho noBabes bemukele usana lwabo	Ezokungcebeleka
Zilengelwa yizembe izethenjwa zeChiefs	Ezemidlalo
Kuzomele anqobe ukuze ageze abaphathi bakhe igilo	Ezemidlalo
Uyabuya owokuvundulula umsakazi woKhozi FM	Ezokungcebeleka
Uphosisile ungqongqoshe ezishaya isifuba emsakazweni	Imibono
I-Wits isenethemba ngoMobara	Ezemidlalo
UNjoko uchaza nge-video yocansi	Ezokungcebeleka
IChiefs ingase isayinise unyazi lomgadli	Ezemidlalo
IChiefs izigwazele ibhece kwiSimba koweCaf	Ezemidlalo
‘Inhloso yami ngokuhlala eKZN wukufunda isiZulu’	Ezokungcebeleka
USiya B uziqhathe nabalandeli ekhalela uZuma	Ezokungcebeleka
OwasoLundi wenza into yamehlo eGermany	Ezokungcebeleka
OwamaBhokobhoko uvivela ukugquzulana neGeorgia	Ezemidlalo
UBenni akaboni simanga esitheni ngokushaya iPirates	Ezemidlalo
Elesizwe lihlose ukungena ngomfutho kwi-Rugby Championship	Ezemidlalo
UNcikazi uncome ezakhe zibuya nephuzu ekuhambeni koweCaf	Ezemidlalo
Abazophatha uhlelo kowama-soapie	Ezokungcebeleka
U-Unathi uphendula othe ugezwe yimali	Ezokungcebeleka
UNcikazi akayizwa eyokubuyela eLiberia koweCaf	Ezemidlalo
ISundowns ihlakaze isidleke ibhudluza Izinyoni	Ezemidlalo
Uziphilisa ngokuphanta uKing Nuba wodumo	Ezokungcebeleka
Ukubambisana kwezemfundo kuletha impumelelo ezweni	Imibono
'U-Erasmus simthole ngenxa kaBenni'	Ezemidlalo
Ziyakhala kuMohale osolwa ngokuqola uSomizi	Ezokungcebeleka
Iqala ngoMsombuluko iKZN SUV Challenge	Ezezimoto
'Abantu baseNingizimu Afrika ababuqondi ubuciko' - Duma	Ezokungcebeleka
Luzoqala ngesonto elizayo uhlelo luka-AKA	Ezokungcebeleka
I-Eagles ivule imidlalo ngewini	Ezemidlalo
Sekusemome ukuqoshwa kwefilimu ngeBoom Shaka	Ezokungcebeleka
URiky Rick uxoshwe yiMabala Noise	Ezokungcebeleka
UThembisa ubonga abamesekile egula	Ezokungcebeleka
UMsawawa uzobonakala efilimini yakuleli	Ezokungcebeleka
URamaphosa akakhulume nezwe uma kubalulekile	Imibono
Kumqoka ukuthembana uma silwa nobhubhane	Imibono
Abesifazane abawuvali umlomo ngendodana kaRamaphosa	Ezokungcebeleka
ISundowns ibuye nawo ephelele amaphuzu kwiChippa	Ezemidlalo
Akazisoli ngokungalali owaba owokuqala kwinhlolokhono yama-Idols	Ezokungcebeleka
Ithembisa okwehlukile iJoyous 23	Ezokungcebeleka
Umshikashika wokuvika izembe	Ezemidlalo
Akaphumeli obala ngokwamxosha kwiBucs	Ezemidlalo
I-United ishaya phansi ngonyawo ngokudayisa uWilliams	Ezemidlalo
Balule isikhathi kwabafuna ukungelema kumaSatma	Ezokungcebeleka
Kulindelwe izipheshethwa iMax's Lifestyle ithulwa	Ezokungcebeleka
I-ASA ilekelela abahlulwa yizikhathi zama-Olympic	Ezemidlalo
Umsindisi weChiefs ucaba indlela eya phesheya	Ezemidlalo
UNtando ubopha omkhomba koweBig NUZ nezidakamizwa	Ezokungcebeleka
UBonang ‘uthenjiswe’ umshado yinjinga yaseZim	Ezokungcebeleka
IChippa iqophe umlando ingena kowamanqamu eNedbank Cup	Ezemidlalo
Qhude manikiniki: Mercedes-AMG A 35 4Matic Sedan vs BMW M235i xDrive Gran Coupe	Ezezimoto
OwoSuthu uchazwa wuthando lwabalandeli	Ezemidlalo
UMicho uqagele ikusasa likaMokwena	Ezemidlalo
Akuthembisi ngezinkunzi kwi-Afcon	Ezemidlalo
'Akube nendlela ehlukile yokukhumbula Isilo'	Ezokungcebeleka
‘URobbie Malinga wangivalelisa ngengoma’	Ezokungcebeleka
Uhluleke ukuzibamba wakhala uConnie Ferguson ebuka iThe Queen	Ezokungcebeleka
OwaKwaNongoma umele iKZN kuMiss South Africa	Ezokungcebeleka
Baduduze imindeni ngezijumbane	Ezokungcebeleka
Kumbulwa kwembeswa kumculi kamaskandi	Ezokungcebeleka
Ubunzima kwi-Arrows ezobhekana neBucs	Ezemidlalo
UBig Zulu useyinxusa likaBrentwood kuleli	Ezokungcebeleka
UKekana akachazeki ngokuphuma iqhubu kwabanye	Ezemidlalo
UNxesi ubukela phansi abasebenzi	Imibono
Yisikhathi sezinguquko emisakazweni	Ezokungcebeleka
Obeyithemba likaSolinas angase angabe esabonakala	Ezemidlalo
Uthi banethuba lokushaya uSuthu	Ezemidlalo
UHarris uthwele amaphupho akuleli kwi-US Open	Ezemidlalo
USenong uchazwe wumgadli ogile iChiefs	Ezemidlalo
IDowns kwamanye amarekhodi kwiDStv	Ezemidlalo
Akazisoli ngokulandela iphupho lakhe owashiya umsebenzi	Intandokazi
Isitholakele i-USB 'ebilahlekile' kaBabes Wodumo	Ezokungcebeleka
'Ngikujabulele ukugqoka ijezi leqembu elikhulu njengeChiefs' - Vries	Ezemidlalo
Luyabuya uGu Jazz Festival	Ezokungcebeleka
[IMIBONO] UNgizwe unekhono lokusakaza umaskandi nokufundisa uyakwazi	Ezokungcebeleka
Iphucwe iqatha emlonyeni iSAFA incishwa i-AFCON	Ezemidlalo
Ikhefu aliyiphuphisanga iSundowns Ladies	Ezemidlalo
Zindizela phezulu iZinyoni ziwina okokuqala	Ezemidlalo
UTruter ufanise usizi lwakhe nolukaPitso	Ezemidlalo
'Asingaphoqwa ukugqoka inzilo'- Ayanda Ncwane	Ezokungcebeleka
Kugqabuka igoda phakathi kukaShaka neThe Queen	Ezokungcebeleka
I-Ranger Thunder igabe ngezobuchwepheshe	Ezezimoto
‘Ayisezoxhaswa imicimbi enotshwala’	Ezokungcebeleka
Yisikhathi sokuthi i-IFP izihlele kabusha	Imibono
UPitso udle iChampions League wavukwa wulaka	Ezemidlalo
Ufuna ukuzivulelaeyakhe indawo yokujima	Intandokazi
Ube mnyama uKhisimusi bengaholelwa	Ezokungcebeleka
Usejahe ukubonakala kwi-OPW	Ezokungcebeleka
UKeet uvikela iWits ngokubheda kohlelo	Ezemidlalo
Kumnadi futhi kuhamba kahle emshadweni wabo	Ezokungcebeleka
Luzokhonjiswa ngoDisemba uhlelo lukaMsizi	Ezokungcebeleka
UDJ Fresh usethole ikhaya elisha lokusakaza	Ezokungcebeleka
Ubalisa ngenkinga yemali oweSSU	Ezemidlalo
OweLadies House nesifiso sokuvikela abesifazane	Ezokungcebeleka
IPirates kumele ifike koweCaf ibukhali	Ezemidlalo
OweSundowns ufuna incazelo kumajaji ngawePSL	Ezemidlalo
Bazonxusa izithandwa zabo ziyeke ukuqonywa ohlelweni lweTV	Ezokungcebeleka
Umculi ubhoboka ngobumnandi bocansi nekati	Ezokungcebeleka
Likhulu ithemba kwaHyundai ngeKona	Ezezimoto
Inonele ngaphakathi                 iKia Pegas	Ezezimoto
USteve Komphela uzibona engaphephile ezembeni	Ezemidlalo
UZandie uncoma abesilisa abanothando ngengoma	Ezokungcebeleka
U-Amla uchazwe wu-Van der Dussen noHendricks	Ezemidlalo
Izinsongo zokubulawa kwabadlali baseColombia	Ezemidlalo
Ivuke ngo-Eymael iBlack Leopards	Ezemidlalo
Qaphela uma kuthiwa thwasa ukuze ungazifaki enkingeni	Imibono
UBaxter usakholelwa                            ku-Akpeyi emapalini	Ezemidlalo
UMbhishobhi Dube ugonyuluka ngokuhabula	Ezokungcebeleka
Iqhawe leChiefs lizimisele ukubuya	Ezemidlalo
Akukacaci ngeqembu elizonyukela kwiPSL	Ezemidlalo
Ulozolo oluzovala isikhala se-Rhythm City: e.tv	Ezokungcebeleka
Imicimbi ibuzwa eThekwini ngoDisemba	Ezokungcebeleka
Uthusa abaqeqeshi uJali obonakala ezelwe kabusha	Ezemidlalo
‘Kumele siqine emqondweni uma sesibhekene neChippa’	Ezemidlalo
IRoyal AM iqhubekile nokuthela umpentshisi kwiPSL	Ezemidlalo
IBanyana inentshisekelo yokwenza kahle eGhana	Ezemidlalo
Kwethulwe umqhudelwano i-Africa Athletics League	Ezemidlalo
I-Arrows ilinde i Chiefs yaze yahamba eMagogo	Ezemidlalo
Unephupho lokuvelela ngamagoli kwiPSL	Ezemidlalo
Ukuqwala izintaba kumelapha umphefumulo	Intandokazi
Bazobhodla kwi-albhumu ngezinkinga zabo	Ezokungcebeleka
Aseqalile amalungiselelo amaSaftas	Ezokungcebeleka
Ukhuliswe abantu abayisibonelo esihle	Intandokazi
Uqongelela udoti ukusiza isikole sakhe	Intandokazi
Sezicula elinye iculo izinyanga ezathi uNcwane uthwetshuliwe	Ezokungcebeleka
Kusinda kwehlela kowe-Ajax Cape Town	Ezemidlalo
UBenni uthole ukuphefumula uSuthu lunqoba kwiligi	Ezemidlalo
Ithembisa okukhulu iMabala Noise ebuyile	Ezokungcebeleka
Kuxhaphazela izisu kwiBarca ngoMessi ofuna ukuhamba	Ezemidlalo
Ningayikhohlwa iMini JCW Clubman bo	Ezezimoto
OweGalaxy uhlose ukuzimaketha kwiPirates	Ezemidlalo
AmaZulu FC ashubisela iPMB ngoKhenyeza	Ezemidlalo
Kubhekwe izinkunzi zaseSoweto kusongwa iligi	Ezemidlalo
Ukuzikhunga kukaPatrick kuqubula imibuzo	Imibono
UPitso uhlaba amaqembu achizela eyeCAF	Ezemidlalo
UPitso unkemise iningi evuna uBangaly	Ezemidlalo
UNeymar usunduza uCavani kwiPSG	Ezemidlalo
Umsakazi usolwa ngokuqola umlaleli	Ezokungcebeleka
Qala ekugcineni uhlehlele emuva	Ezokungcebeleka
Kuningi okusididayo njengoba izwe livaliwe	Imibono
Umhlaziyi akaboni iSundowns izowubamba umgqigqo wokungahlulwa kwiligi	Ezemidlalo
OweTeam of Choice  usongela iSundowns	Ezemidlalo
UDolly uzoyibuka ekhaya i-AFCON	Ezemidlalo
UBaxter uhlabeke umxhwele ngabeqiwa ijezi kwiChiefs	Ezemidlalo
ISundowns Ladies izobhekana nelaseZambia kowandulela owamanqamu	Ezemidlalo
UKhanyi Mbau ulaxaze Abomama	Ezokungcebeleka
Injini yeCity izolibhekisa phesheya	Ezemidlalo
Ucikwe unompempe wasikaza ukushiya uMcCarthy	Ezemidlalo
Ufisa ukunqoba esesithathu  seNedbank Cup	Ezemidlalo
Isempini enzima i-Opel Corsa	Ezezimoto
Unozinti uzimisele ngokwelula inkontileka eNaturena	Ezemidlalo
Sekuphenduke isitayela ukuphuca	Intandokazi
I-Sundowns izobhekana neBucs inomfutho	Ezemidlalo
U-Abrahams ugila izimanga phesheya	Ezemidlalo
Umndeni ubonga uthando lwesizwe	Ezokungcebeleka
Injabulo iligi yabesifazane ithola abaxhasi	Ezemidlalo
[EZOTHANDO] Umamezala ugoloze nepasi lomyeni wami oshonile	Ezokungcebeleka
Wale waphetha ukushutha nozakwabo	Ezokungcebeleka
UShenge uphawula ngabathi ubambe iSilo ngoqhotho	Imibono
I-The River yemuke nezindondo eziwu-10	Ezokungcebeleka
ISundowns isaqhubeka nokuqoqa amaphuzu kweyeligi	Ezemidlalo
Usuku oluhle kwimbokodo: Isolezwe	Intandokazi
OweRoyal AM usazoqhubeka ngabedlala ngabo kwiCeltic	Ezemidlalo
Kunconywa oweSwallows ngokuhlanganisa iqembu ngasebekhulile	Ezemidlalo
UBavuma uvuma induku kwi-T20 yokuqala	Ezemidlalo
UPitso udangele ngoweDowns	Ezemidlalo
BUKA: UBabes Wodumo ukhuze umhlola kuthiwa akehlise umsindo	Ezokungcebeleka
Ongakwenza ukugwema ukudunwa imoto	Ezezimoto
Kushubile emaqenjini alwela ukungena kweyePremiership	Ezemidlalo
Usaziwayo ukhala ngezinhlelo ezingakhi kwiTV	Ezokungcebeleka
Akuphelile ngoKomphela ebholeni: Sukazi	Ezemidlalo
Akanalo uzwelo ngoWalusimbi	Ezemidlalo
‘ISafa ayiqashe inqwaba yomakadebona’	Ezemidlalo
Zingenisile emculweni izelamani zaseBergville	Ezokungcebeleka
UKhuzani uzohlanganisa uTalugu kwiFull Up	Ezokungcebeleka
Kukhonye abasafika kwethulwa amaMetro FM  Awards	Ezokungcebeleka
Uvalo ngodumo koweChiefs	Ezemidlalo
UTete ethubeni lokubuyela ezingeni lomhlaba	Ezemidlalo
Isizini ebe yinhle kunawo wonke kuSiyanda Xulu	Ezemidlalo
UTinkler uyale abadlali bangahluthukelwa yizinhliziyo	Ezemidlalo
Inzima indlela yeSundowns kwiChampions League	Ezemidlalo
Bathembisene umshado uMusa nowayenguMiss SA	Ezokungcebeleka
Bahoxile kwele-PSL abakwaMpisane	Ezemidlalo
UKhuzwayo uvula isifuba ngengxoxo noninakhulu	Ezemidlalo
Ubungozi ngoqhekeko lwe-ANC eThekwini	Imibono
UNyazilwezulu ngolwethu koze kube sekugcineni!	Imibono
Masilwe nokwebiwa kokudla okuthengelwe abampofu	Imibono
Ubona besengenza kahle kweyeCAF	Ezemidlalo
IBig Nuz iqopha umculo omusha	Ezokungcebeleka
UMathoho uchayise awaphesheya	Ezemidlalo
"""UKomphela usebenzile kwiChiefs"""	Ezemidlalo
Zizoxebula umkhoma izinhlangano zamaciko ngomcimbi kaCassper	Ezokungcebeleka
UBaxter nenhlansi yethemba ngendawo ayidlalise uNgcobo	Ezemidlalo
IFifa iwabuyisela kwasifuba aweSafa kolweGhana	Ezemidlalo
Kubalulekile ukuphepha ezikoleni	Imibono
USomizi uthembise isithandwa sakhe umshado	Ezokungcebeleka
Kuphelile ngeMabala Noise	Ezokungcebeleka
Umsamo wakho owamathongo, hhayi ugobela	Imibono
'UDube uzoqhakaza kwiChiefs'	Ezemidlalo
UDavido uzonandisa eYadini ngoSepthemba	Ezokungcebeleka
Uyazigqaja ngeLimpopo uSho Madjozi ohlabane ngendondo yeBET	Ezokungcebeleka
UGumede uhlaba indlela okuphathwe ngayo ekaSithebe oSuthwini	Ezemidlalo
UMcCarthy uncoma ikhono lomdlali ofikayo	Ezemidlalo
UHunt akanavalo ngabadlali bakhe	Ezemidlalo
Bajabule ngesasasa leRenault Sandero Stepway	Ezezimoto
Kunyukile ukudayisa kwezimoto	Ezezimoto
Ziyime emthumeni ngekusasa leCeltic	Ezemidlalo
Kujabulisile ukubona abalingisi abasha	Ezokungcebeleka
UTira uchaza ngokwenza ingoma noBabes noMampintsha	Ezokungcebeleka
Usezitokisini uNgizwe Mchunu	Ezokungcebeleka
UKelly uyaveva ngokubizwa kwendoda yakhe ngomlungu	Ezokungcebeleka
Lihoxisiwe icala ebelibekwe uSbahle  Mpisane	Ezokungcebeleka
ICorona ibhuntshise owamaBhokobhoko neGeorgia	Ezemidlalo
Inyanga ezocacisa ngamaphupho eSundowns	Ezemidlalo
Ubonga amaCrown owine izindondo ezimbili	Ezokungcebeleka
Ushumayela ivangeli lokuzithoba uSredojevic	Ezemidlalo
IPirates imise umdlali ovulelwe icala	Ezemidlalo
UManyama ubona ubungozi kwiPirates	Ezemidlalo
Kuzoqhuma isililo kubadlali abanamagama kwi-Eagles	Ezemidlalo
Lihlehlele unyaka ozayo elikaNgizwe	Ezokungcebeleka
Kuzovulwa maduze iMusic House KZN ebivaliwe	Ezokungcebeleka
Owe-Arrows uchaza ngokwamukela isimo	Ezemidlalo
IBafana izibeke ebuhleni inqoba kwiGhana	Ezemidlalo
UBrockie uzwakalisa ukuphoxeka ngoTinkler	Ezemidlalo
Inkulumo kaRamaphosa ibahlabe umxhwele eMabhida	Ezokungcebeleka
Isiqalile ukushosholoza inqola yeSundowns	Ezemidlalo
Umaskanda uGadla kuQhosha ngengoma	Ezokungcebeleka
Uvivela oweChiefs uMosimane	Ezemidlalo
Abadlali abayizwa eyeVAR  kweyoMhlaba	Ezemidlalo
Kwehla isibalo sababukela Uzalo	Ezokungcebeleka
Yiba neqiniso Ngqongqoshe uBlade Nzimande	Imibono
Kuyingozi ukushayela eNingizimu Afrika: Ucwaningo	Ezezimoto
'Zihamba ngolayini' izinto kuLady Du	Ezokungcebeleka
'Ubeyindoda ebinothando uMabena'	Ezokungcebeleka
Qondisisa ezokuphepha ezisemotweni yakho	Ezezimoto
Uzime usuku uluqale ngokumukela imoto	Ezokungcebeleka
Zizobuya ngenkani izimoto zakwaChery	Ezezimoto
Akuthi diki kubalandeli abavota kwiBlack Label Cup	Ezemidlalo
Ukhala ngokuhlala kuleli kukaKhune	Ezemidlalo
Indida ngekhefu lika-Alex Mthiyane	Ezokungcebeleka
UDJ osolwa ngokuthwala ngozakwabo ubopha umsakazi	Ezokungcebeleka
Kade ayexoshwa onqobe iNedbank Cup neTTM	Ezemidlalo
IPajero Sport ayinakwa kepha isezingeni eliphezulu	Ezezimoto
Nginecala ngokuthandana nendoda eshadile: Kelly Khumalo	Ezokungcebeleka
Ubona iWits izoba umjovo wokuvuka	Ezemidlalo
Bamanqika ukuphumela obala ngokulobizela isicoco	Ezemidlalo
Lichithiwe icala lomlingisi weSibaya obesolwa ngetulo lokubulala umyeni	Ezokungcebeleka
Ukucula eYadini akumqhelisile nenkolo	Ezokungcebeleka
Ukhunjulwe ngamagalelo aphusile uMenzi Ngubane	Ezokungcebeleka
Izogubha nosaziwayo inyanga yodumo	Ezokungcebeleka
UNene uzosebenzisa iDiamond League ukuhlungela ama-Olympic	Ezemidlalo
UMngqithi usasazela AmaZulu nge-Arrows	Ezemidlalo
Umlingisi weHostela usinde eqolwa	Ezokungcebeleka
Asingavumi ukulawulwa ngamaqembu ezepolitiki siwumphakathi	Imibono
[IMIBONO] Okwenzeka oKhozini kuqubula imibuzo eminingi	Ezokungcebeleka
OLYMPICS: Elakuleli livule ngebatha eTokyo	Ezemidlalo
Mancane amathuba okuvika iCorona	Imibono
UMthalane akethukile ngokungalwi isikhathi eside	Ezemidlalo
Isendleleni iVW Polo entsha	Ezezimoto
Izoshubisa imithetho emisha yebhola	Ezemidlalo
ObekuSuthu usafisa ukudlala esigabeni esiphezulu	Ezemidlalo
Sekufike lapho ecikeka khona uBenni McCarthy	Ezemidlalo
I’Downs iqinise indawo esicongweni kweyeCaf	Ezemidlalo
I-GWM yethule iveni iP Series	Ezezimoto
Babaselekile uZalo lwenza kahle lweqa ku-10m wababukeli	Ezokungcebeleka
UTinkler uyayethemba iPirates ekunqobeni ekuhambeni	Ezemidlalo
Ziyaqala izinyembezi kwi-Euro 2020	Ezemidlalo
[IMIBONO] I-Kaizer Chiefs isilandele imfundamakhwela yomqeqeshi	Ezemidlalo
Uhlohla abakuleli ngomngcwabo kaDe Klerk	Ezokungcebeleka
Ukuzethemba kowaMaZulu ofake amagoli	Ezemidlalo
Ziyaqina ezokuthi uBenni uya kwiCity	Ezemidlalo
Kuhlukene inhloko nesixhanti kuVukusic naMaZulu asezoqhubeka noDlamini	Ezemidlalo
ULorch uzohlala amasonto amahlanu engadlali	Ezemidlalo
IChiefs ibuyisa uqweqwe lomqeqeshi	Ezemidlalo
UMokwena ukhononda ngokunganconywa kwabadlali beDowns	Ezemidlalo
UMulenga ukhalima ozakwabo ngaphambi kowe’Downs	Ezemidlalo
Lubuye nomethuli omusha uhlelo iLove Back	Ezokungcebeleka
#Ezempilo: 'Akubona ubunuku ukungashefi' - isazi	Ezokungcebeleka
[IMIBONO] Uyisibonelo komaskanda uDSD	Ezokungcebeleka
Luyancomeka ushintsho emsakazweni Ukhozi FM	Imibono
Ithuthukiswe ivele isadlisa iVW Tiguan	Ezezimoto
UTycoon limphunyukile ithuba lokuwina ibhande	Ezemidlalo
Ufuna ukukhiphela isibhongo kuMaZulu	Ezemidlalo
Kuvuka igqubu lango-2017 kwiChelsea ne-Arsenal kwiFA Cup	Ezemidlalo
UMcCarthy angeke ahlukane netshe lemali ngomdlali	Ezemidlalo
Ubuya ngokulingisa kuTV uZandi Nhlapho	Ezokungcebeleka
UKhozi aluphumele obala ngengoma yonyaka	Imibono
Injabulo kuBaxter iBafana Bafanaishaya iBotswana	Ezemidlalo
UBaxter uhlabe izithenjwa zakhe ngephenathi egejwe uManyama	Ezemidlalo
ICell C Sharks ayiyithathi kancane iPumas	Ezemidlalo
OweCity embangweni wovelele kwiPSL	Ezemidlalo
Ingena ngamafosholo kuCassper oseyinxusa kwaSamsung	Ezokungcebeleka
ICarling izobuyisela abalandeli enkundleni	Ezemidlalo
ULady Zamar usabanjelwe igqubu ngolukaSjava	Ezokungcebeleka
U-Cndo uyacacisa kolwe-video	Ezokungcebeleka
Uzimisele ngokulwela indawo yakhe kwiDowns	Ezemidlalo
ISafa ithukuthele ngesinqumo seSABC	Ezemidlalo
UXulu ucatshelwa eyokushiya kwiChiefs	Ezemidlalo
UMadlala “usongele” uNcikazi ngamadlelo aluhlaza	Ezemidlalo
UBlack Coffee uphawula ngezinsolo zokuphinga	Ezokungcebeleka
‘Siphoxekile amaProteas eshaya udaka’	Ezemidlalo
Uxwayisa onompempe ngentshontsho	Ezemidlalo
I-Arrows iphendula abayinuka ngokudayisa umdlalo kwiSundowns	Ezemidlalo
Umshwalense okusiza ebunzimeni	Ezezimoto
Kuzoshuba          kwiLove Island SA	Ezokungcebeleka
OwoKhozi ucasule omaskanda eqamba izinja zakhe ngabo	Ezokungcebeleka
UMokwena ugxeka iBafana ngabadlali beSundowns abalimele	Ezemidlalo
Kuwuhambela kahle umndeni wakwaMseleku kwithelevishini	Ezokungcebeleka
Ufaniswe neqhawe umlingisi oshonile	Ezokungcebeleka
UMosimane usegxile kuCAF ChampionsLeague	Ezemidlalo
Impi yamazwi phakathi kukaDlubheke noTshatha	Ezokungcebeleka
Sihlalelwe wumdlalo onzima kwiNigeria: Van Wyk	Ezemidlalo
UKhune uvuma uVries ezintini	Ezemidlalo
Babonga ukwesekwa bethola iMulti Plutinum Disc	Ezokungcebeleka
Inyunyana yabadlali isongela iTshakuma	Ezemidlalo
UNaima Kay ukhipha ingoma entsha ngoLwesihlanu	Ezokungcebeleka
Umbhali woZalo usibukela phansi	Imibono
Izembe kwiChiefs kuthulwa owangaphandle	Ezemidlalo
Ubuya ngolunye unyawo umlingisi uMadluphuthu kwezamafilimu	Ezokungcebeleka
Uvule inkampani yokuzivocavoca osewole izindondo	Intandokazi
UMalesela usewubonile ukhiye wokususa iGallants ezembeni	Ezemidlalo
UBaxter ufuna ukuceba iqembu laseFrance	Ezemidlalo
Ithuba elithokozise uCassper	Ezokungcebeleka
Kubanjwe umoya kwiSuperSport ngesitobha	Ezemidlalo
Usewagaxa emgibeni uHabana	Ezemidlalo
Kumele siphathe kahle imali sibe wumasipala onozinzo	Imibono
Kufunwa ozoxazulula  eyamagoli kweZimnyama	Ezemidlalo
Ukhuza ibuya uKhanya kwi	Ezokungcebeleka
OweDUT uthi bazozibamba ziqine koweVarsity Football	Ezemidlalo
Umqeqeshi waMaZulu nezindlela zokuqinisa ekushayeni amagoli	Ezemidlalo
Usezobonakala kwiMbewu uZookey	Ezokungcebeleka
Uza eThekwini umjikelezo ka-Unathi	Ezokungcebeleka
Kuyasishaya ukungaligcini isiko lenhlambuluko nokuthelelana amanzi	Imibono
Inkakha ifuna uNcikazi kwesokuhola iPirates	Ezemidlalo
Aqhathiwe adlulele phambili kwiMTN8	Ezemidlalo
Ngikhulelwe, ethanda engathandi:Babes	Ezokungcebeleka
I-Lockdown nabalingisi abasha	Ezokungcebeleka
Siphinde sazidonsela amehlo abezindaba isilomo somdlali we-USA	Ezemidlalo
UTinkler akabekelwe mgomo kwiChippa	Ezemidlalo
UKhuzani ucela uxolo kuShenge	Ezokungcebeleka
'UDolly ngeke alinikwe ibhande'	Ezemidlalo
UKwesta uthembisa ulozolo	Ezokungcebeleka
Izinguquko ezinqala kuKhozi	Ezokungcebeleka
UMbazo uncoma iSadtu ngezemidlalo ezikoleni	Ezemidlalo
Sekubanjwe umoya ngeSenegal kweyoMhlaba	Ezemidlalo
UMshunqisi ufuna incazelo kumaSama	Ezokungcebeleka
Izinguquko emsakazweni kuMarawa no-Euphonik	Ezokungcebeleka
Kuningi okukhombise  ubudedengu kwi-IEC	Imibono
UKatsvario usehlukene neSingida yaseTanzania	Ezemidlalo
UCele usazimisele ngokuhlala phesheya	Ezemidlalo
Kusilimazile ukuhoxiswa kwezikhangiso zomsebenzi	Imibono
Unamava eNdebe yoMhlaba	Ezemidlalo
I-Pirates izohlola abadlali koweCarling	Ezemidlalo
UShabba ubalisa ngomgqigqo	Ezemidlalo
Usemanzini umsakazi woKhozi FM	Ezokungcebeleka
AboZalo babongwe ngokuzimisela	Ezokungcebeleka
Uphuthunyiswe esibhedlela umlingisi ngemuva kokuhlaselwa yizigebengu	Ezokungcebeleka
UKekana uvule izandla emaqenjini amfunayo kwiPSL	Ezemidlalo
USosha ubabaza akuzuzile nge-albhamu	Ezokungcebeleka
Iveziwe iFord Ranger entsha ceke	Ezezimoto
Uthembise umshado kwiVDJ	Ezokungcebeleka
ISundowns yethule ukotini wayo omusha	Ezemidlalo
Ukhala ngeshobolo uNcikazi kulimala omunye umdlali	Ezemidlalo
INingizimu Afrika idinga umengameli wesifazane: Simphiwe Dana	Ezokungcebeleka
Asiyiphuphi ngisho silele eyokudliwa yizembe: Freese	Ezemidlalo
UGcaba usecele ukukhululwa ebhentshini leBucs	Ezemidlalo
Unqobe sekuvalwe amehlo uBabo	Ezokungcebeleka
U-Owami Mafokate usekulungele ukuzakhela igama	Ezokungcebeleka
Babaqinisa idolo abeBanyana abaphesheya	Ezemidlalo
Umyeni usentshontshana nosisi wami esihlala naye	Ezokungcebeleka
Injabulo kwimenenja kuxoshwa oweChiefs	Ezemidlalo
Ucikwa ukumataniswa neBafana uHunt	Ezemidlalo
Imenenja isabela uLorch kubalandeli ngenxa yamahlebezi	Ezemidlalo
Abama-80s abahlukane nokutinyela ama-2000	Imibono
UCavin ufuna inguyazana nabalandeli	Ezemidlalo
UBabes Wodumo ubengazi ngoweMetro	Ezokungcebeleka
Bachaza ngokungaqokwa kukaKhuzani kumaSama 27	Ezokungcebeleka
Umaskanda weyodumo ulahlekelwe	Ezokungcebeleka
Uyachichima yinjabulo umculi eteta usana	Ezokungcebeleka
OweMuvhango uzuze iziqu zobudokotela	Ezokungcebeleka
UNgqongqoshe uMshengu useyangiziba ngemali yami	Imibono
Kusenovalo ngezimoto ezihamba ngogesi	Ezezimoto
Baphakamise ifulegi lakuleli kowama-Oscar	Ezokungcebeleka
UBongani Fassie nohlelo ngempilo yakhe kuMoja Love	Ezokungcebeleka
Kuphelile ngoZodwa Wabantu nesoka lakhe	Ezokungcebeleka
Ucela ukuhlonishwa osolwa ngokulala noZodwa	Ezokungcebeleka
UCarol Ofori ubuyelekwi-EastCoast Radio	Ezokungcebeleka
Unozinti wegoli leBucs akayingeni eyezintombi	Ezemidlalo
Indumalo ezweni kushona uBob Mabena	Ezokungcebeleka
OweBafana wexwayisa ngobungozi be-Ethiopia	Ezemidlalo
Kulindelwe isinqumo kolukaSemenya ne-IAAF	Ezemidlalo
Ngeke wabhajwa uhamba ngeFord Ranger Raptor	Ezezimoto
UNaima Kay akakholwa ezocula neJoyous	Ezokungcebeleka
Luyethusa olokwamukelwa kwezingane zabokufika	Imibono
‘UMampintsha ulisulile icala ayelivulele uBabes’	Ezokungcebeleka
UBabes Wodumo uchitha ukuthuka uLady Zamar	Ezokungcebeleka
Kuzoklonyeliswa abesifazane abavelele kwezemidlalo	Ezemidlalo
Kunyukile ukuthengwa kwezimoto ngoJuni	Ezezimoto
Ayiphuzi iyabuhlaba intsha KwaNongoma	Imibono
Iyavuthwa ebheke kwiDowns kuBrockie	Ezemidlalo
Yize esacula kodwa usefisa ukusakaza	Ezokungcebeleka
'Ayikho indaba yabadlali baseNingizimu Afrika' - Benni	Ezemidlalo
Sicela uMbalula afike azozibonela	Imibono
ISundowns nomlando inqoba isicoco seDStv Premiership	Ezemidlalo
Ukudliwa ngekhona akwamukelekile: Dlamini	Ezemidlalo
AbaseNigeria bayivumile induku abathelwe yona	Ezemidlalo
Masiphuce i-ANC amandla sibuyise umnotho wezwe	Imibono
Benze ezibukwayo abalaxazwe uMashaba	Ezemidlalo
IChiefs isabheke lukhulu kuLetlotlo	Ezemidlalo
Imboni yamatekisi idinga amasu namaqhinga amasha	Imibono
Abayizwa eyokubulawa kukaMndeni abeHostela	Ezokungcebeleka
IBucs ishiywe yisilomo somdlali	Ezemidlalo
UZungu ufuna ukuqeda ukukhonya kweSundowns	Ezemidlalo
EZOTHANDO: Ngishadelwe nginabantwana kodwa ngisawathanda amadoda	Ezokungcebeleka
UMusa Sukwene ubuyela kuma-Idols	Ezokungcebeleka
EZOTHANDO: Ngimncisha ucansi ngoba echamela isihlalo sethoyilethi	Ezokungcebeleka
'Uvalo lubanga amaphutha konompempe'	Ezemidlalo
Uthole umklomelo ophezulu wesayensi	Intandokazi
Isaqaqanjelwa yinhliziyo indodakazi kaSifiso	Ezokungcebeleka
ULaffor akafuni ukucacisa ngekusasa	Ezemidlalo
Ezolimo ziwubizo kumlimi osemncane	Intandokazi
Ngidlulisa umyalezo ngabezindaba: Steve	Ezemidlalo
Kuphuma iqophamlando likaNasty C	Ezokungcebeleka
UBig Zulu uyethule ngempumelelo i-albhamu yakhe	Ezokungcebeleka
Akucaci ngekusasa likaSunday kwiSibaya	Ezokungcebeleka
‘Mkhulu umsebebenzi ongihlalele kwiChiefs’	Ezemidlalo
'Sisazomqasha uMampintsha' - Abahleli bomcimbi	Ezokungcebeleka
Injabulo kusaziwayo okhulelwe	Ezokungcebeleka
UWilliams akafuni babe yibhuloho elizoweza omkhaya	Ezemidlalo
Isikile iChiefs kuBaxter: Ntseki	Ezemidlalo
UKhuzani ugiye ngengxabano noNgizwe	Ezokungcebeleka
ISilo esibusayo masihlonishwe njengoyise	Imibono
Ukhombise ukuvuthwa uTshatha elawula abomkhankaso	Imibono
Ubuyela kuKhozi FM umsakazi obemisiwe	Ezokungcebeleka
Amehlo azobheka i-Egypt neNigeria kuGroup D	Ezemidlalo
Uzocula bukhoma eNanda uJoel	Ezokungcebeleka
Uqophe ibika leLockdown kukubi	Ezokungcebeleka
Ulale esitokisini uR Kelly ozinikele emaphoyiseni	Ezokungcebeleka
Bagadlana ngengoma ababanga izintombi	Ezokungcebeleka
Udayisa amakota ukuze ayofunda owaKwaMashu	Intandokazi
Akayixoxi namuntu eyomqeqeshi weMpofana	Ezemidlalo
UCassper embangweni wengoma nophrojusa	Ezokungcebeleka
Zidla ubhedu izifonyo ezinezithombe zabantu	Intandokazi
OwamaSharks ukhale ngokushoda kwabadlali behlulwa	Ezemidlalo
Elama-Olympic lizozicija ngamaqembu anzima	Ezemidlalo
Uzifake emlandweni owePirates bepokela iChiefs	Ezemidlalo
UMemela noSiphiwe Tshabalala kubadlali abasha boSuthu	Ezemidlalo
Aseyaphela amathikithi oweBucs neChiefs	Ezemidlalo
Abaneme ngokungaqokwa kukaMakhadzi kumaSAMA	Ezokungcebeleka
Sesifikile isikhathi sokuthi ixoxo nexoxo lizigxumele	Imibono
Kungasibuyiseli emuva ukuxegiswa kwemigomo	Imibono
Ubanjiswe esokuphatha uKhozi FM	Ezokungcebeleka
Unqobe izinselelo onikwe esokuphatha ophikweni i-ATNS	Intandokazi
AmaZulu azobhekana nesishingishane: Hunt	Ezemidlalo
Uzongcwatshwa ngesonto elizayo uTsepo Tshola	Ezokungcebeleka
Abathi vu ngokushiwo ezinkundleni zokuxhumana ngoBabes	Ezokungcebeleka
I-ANC ayivume ukuthi bujulile ubuqembuqembu	Imibono
Injabulo uDineo ebuya emoyeni	Ezokungcebeleka
Ihlukile kunamanye iKia Picanto X-Line	Ezezimoto
Kuzwele kwizintombi nto ukukhothama kweSilo	Intandokazi
Abagobe uphondo manje abasebenzi baseSAA	Imibono
UCassper kumhlulile ukugcwalisa iMabhida	Ezokungcebeleka
Kuzodela umakhasana kowe-Eagles noThongathi	Ezemidlalo
Ingalokothi isizele ngobuso iBucs: Ncikazi	Ezemidlalo
UZinnbauer ubona ithuba lokuvikela iMTN8	Ezemidlalo
Ubesephosa ithawula ebizwa yi-Ambitiouz oshaye ingoma noBig Zulu	Ezokungcebeleka
Kuzohlomula abasafufusa ngeLockdown House Party	Ezokungcebeleka
BUKA: Umndeni waseDundee uthandazele uZodwa Wabantu	Ezokungcebeleka
Sivalwe uqweqwe lomsakazi esikaQueen B	Ezokungcebeleka
ISafa imise onompempe ngephenathi emdlalweni woSuthu neChiefs	Ezemidlalo
IKings seyimfune yancama onyamalale ezama inhlanhla	Ezemidlalo
Uyocijwa phesheya oweTeam of Choice	Ezemidlalo
Hlala ngendlela efanele emotweni	Ezezimoto
Kuqalwe uphenyo ngengoma kaNova	Ezokungcebeleka
UTovey unxusa ukuthi uHunt anikwe ithuba elanele kwiChiefs	Ezemidlalo
Wacishe wazibulala emuva kokudlwengulwa oweDiepCity	Ezokungcebeleka
UTendai Ndoro umataniswa neKaizer Chiefs	Ezemidlalo
Uyomela iNingizimu Afrika kuMiss Universe owakuleli	Ezokungcebeleka
Masihlukane nezinkulumo ezingamanga nezidukisayo	Imibono
IBucs ihlulekile wukugudluza omkhaya ibanjwa	Ezemidlalo
UHunt ucacisa ngekusasa likaBilliat eNaturena	Ezemidlalo
Umisiwe emsebenzini owezikhangiso ze-Outsurance kulandela izinsolo zokuphinga nokuhlukumeza	Ezokungcebeleka
UThando Thabethe usekulindele ngabomvu ukusakaza kwi-947	Ezokungcebeleka
I-Eff ifike kwezwakala yadlondlobala	Imibono
Isidididi kukhishwa abaculi kumaSama	Ezokungcebeleka
UZinnbauer uminciswe amazwi embangi ngoweCaf	Ezemidlalo
OweBay uthembisa ukuvuka bazithathe behlulwa isicoco	Ezemidlalo
Isitobha seRoyal Eagles sidalula okusenza singalibheki ipali	Ezemidlalo
ICoastal  kowamanqamu eCompact Cup	Ezemidlalo
I-Covid-19 ilekelele iBlack Mambazo yasiza amaciko	Ezokungcebeleka
UBlack Coffee uthenge indawo yobumnandi edumile	Ezokungcebeleka
Iza ngonyaka ozayo            iBMW iX3	Ezezimoto
U-Erasmus ujabulela ithuba lokuvivinya abamaBhokobhoko	Ezemidlalo
Abazisoli ngokuba yingxenye yohlelo lwezangoma kuMzansi Magic	Ezokungcebeleka
Kulindeleke izinguquko kwiMetro FM	Ezokungcebeleka
AboKhozi FM bazobanga abalaleli	Ezokungcebeleka
Umdlalo omusha okhuthaza nofundisa imbokodo	Ezokungcebeleka
Ucela ukunikwa ithuba uMosimane	Ezemidlalo
ULira uhlela ukuhlukanisa nomyeni wakhe	Ezokungcebeleka
IMIBONO: I-PSL kumele yenze izinto ngendlela efanayo emacaleni	Ezemidlalo
Asixazulule izinkinga, siyeke ukulwa sodwa singama-Afrika	Imibono
UZinnbauer uyibukela kude eyombango wesicoco seligi	Ezemidlalo
UCaster uzodalula konke ngempilo yakhe encwadini	Ezemidlalo
U-AKA uchaza ngobuhlungu bokushonelwa yingoduso	Ezokungcebeleka
UMemela ubona Usuthu selulungele izindebe	Ezemidlalo
Kumqoka ukuphepha kothisha nabafundi	Imibono
Ushiye isigubhukane oweGagasi	Ezokungcebeleka
UJali utuse odokotela beSundowns ngokumelapha	Ezemidlalo
Kumele seseke intsha yakuleli futhi siyilalele ukuthi ifunani	Imibono
Obeyisikhulu sakwa-Engen usengumnikazi wegalaji	Intandokazi
Uzithwese umthwalo wamagoli (30)	Ezemidlalo
Zilinyusile izinga izinsizwa kuma-Idols SA	Ezokungcebeleka
UZola 7 obexinwe yisifo sokuwa useyalulama	Ezokungcebeleka
Ujabule uKhuzani ozohlonishwa emcimbini	Ezokungcebeleka
Angase alandele uMosimane umdlali ongayibheki inethi	Ezemidlalo
Kuzoyikhathaza  ukuphumula kuze kweqe iManiema -Mngqithi	Ezemidlalo
ISafa izocacisa ngokucwila kukaR74 million	Ezemidlalo
Akwaziwa mbhantshi ukujiya kuMosimane ne-Al Ahly	Ezemidlalo
Uphoqeleke ukuyeka ibhola oweBucs	Ezemidlalo
'Ngiyaxolisa ukuthi owesifazane wahlukumezeka ngenxa yami' - Okmalumkoolkat	Ezokungcebeleka
Ufuna uBaxter aqinise iqembu ngabawina zindebe	Ezemidlalo
Owasinda ekufeni unethemba lokuba uMiss South Africa	Ezokungcebeleka
Baqhakambisa ubuhle bezimoto kwaPeugeot	Ezezimoto
OweSekhukhune ufuna ukufaka ingcindezi ngombango wesicoco	Ezemidlalo
‘Nathi sinesandla ekuhambeni kukaTinkler’	Ezemidlalo
Ukhuza ibuya owahamba ebhedelwa wuhlelo kwiSibaya	Ezokungcebeleka
Awusisweli isikhala kwiBMW 4 Series Gran Coupé entsha	Ezezimoto
I-Bucs iqhubekile nokulahla amaphuzu	Ezemidlalo
Kunzima kuMosimane ukwamukela ukuhluleka	Ezemidlalo
UZongo ubonge abakwaMpisane ngethuba	Ezemidlalo
UMnyango unikele ngezinsiza zokuziqeqesha kumabhokisa	Ezemidlalo
Uvumbuke kwiLeopards uMncwango	Ezemidlalo
Iyagqama esixukwini iCitroen C3	Ezezimoto
UMazinyo usaba imbazo kwiZesco	Ezemidlalo
‘Ngiyaqala futhi ngiyagcina ukungenela amaCrown’	Ezokungcebeleka
BUKA: Umsindo uMampintsha 'eshaya' uBabes kwivideo	Ezokungcebeleka
I-BMW 330is Edition ihlonipha iGusheshe	Ezezimoto
Ikusasa likaZungu kwiRangers engcupheni  ephoxa uGerrard	Ezemidlalo
IJoyous izokhulekela ukhetho	Ezokungcebeleka
UDJ Sbu usonga ngokuthathela uZahara izinyathelo zomthetho	Ezokungcebeleka
Ishintshe kakhulu iMazda BT-50 entsha	Ezezimoto
UNhlapo ubona beshaywe kungafanele	Ezemidlalo
IBafana izehlisele ingcindezi iguqisa iZimbabwe kowokuhlunga	Ezemidlalo
Kube nzima ekhumbula izigameko zokudlwengulwa	Ezokungcebeleka
Ngibona sisazodliwa yinhlupheko eMzansi	Imibono
‘Abazali bangisiza ngophiyano’	Intandokazi
'Ngibuyekile!' Kwazisholo isidakwa kuwuMsombuluko	Ezokungcebeleka
UDemi-Leigh ubonge ukwesekwa enqoba isicoco sikaMiss Universe	Ezokungcebeleka
IBafana ethubeni lokuzihola kuGroup C	Ezemidlalo
Ziyanda izindondo zakuleli kuma-Paralympic	Ezemidlalo
Ukhiphe ingoma ngoJub Jub uzolandelisa nge-albhamu	Ezokungcebeleka
Uvunywe uJohn Cena uSho Madjozi	Ezokungcebeleka
Azikadingeki izihlwele ezinkundleni	Ezemidlalo
'Kungenzeka ukuthi ngiwiswe uwaya ngoba bengingeke ngiwe nje' - Emtee	Ezokungcebeleka
Utusa induku entsha yeChiefs	Ezemidlalo
Uchitha ekaMkwanazi nePirates	Ezemidlalo
I-Al Ahly yiqembu elikhulu kune-Brighton: Pitso	Ezemidlalo
Ingase yehle intengo kaphethroli ngo-Okthoba	Ezezimoto
Iziteleka ngamaholoziphoxa amazwe ase-Afrika	Ezemidlalo
UBusisiwe embuthanweni wababhali	Intandokazi
Uzoganela esithenjini udadewabo kaMseleku	Ezokungcebeleka
Ichithiwe i-Ajax kolwama-play offs	Ezemidlalo
AbaKwaShembe babhoka ngomdlalo omusha wombango ebandleni	Ezokungcebeleka
UBoneni ukhala ngokubanjiswa udonga	Ezokungcebeleka
Uhlangene umndeni wamaSUV akwaVW kufika iT-Roc	Ezezimoto
UKhune iyamkhuthaza eyokugxekwa	Ezemidlalo
UNgcobo ufisa ukugijima kuma-Olympic	Ezemidlalo
UMaster KG uvunwa yizinto emculweni	Ezokungcebeleka
Izinselelo zokuqhubeka nesikweletu somunye emotweni	Ezezimoto
UCele ushaywe ngesithende yiGolden  Arrows	Ezemidlalo
UZozibini uzobambisana nowaphesheya kokaMiss SA	Intandokazi
Imile imizi ngenxa yakho MaGumede	Ezokungcebeleka
IMoja Love nohlelo losomabhizinisi	Ezokungcebeleka
‘Akukona ukubuyela emuva ukudlala kwiNFD'	Ezemidlalo
#Ezothando: Umkami akazithandi uyinuku nendlu igcina isihlanzwa yimi	Ezokungcebeleka
Wenyuselwe iholo owe-Ea Lla Koto	Ezemidlalo
IBucs nethemba lokuthola uBen	Ezemidlalo
Imenenja ichaza ekaBilliat neChiefs	Ezemidlalo
UMusona uzoqhubeka ahlale eBelgium	Ezemidlalo
ULinda Gcwensa ne-albhamu entsha	Ezokungcebeleka
Usene EP obecula nabazali kuFacebook	Ezokungcebeleka
URonwen ukhuza umhlola ngeBafana	Ezemidlalo
UNcikazi unethemba ngomdlalo wabo olandelayo	Ezemidlalo
Udumo lweJerusalema lungenisa nemali	Ezokungcebeleka
UBusiswa ubonge uProfessor ngempumelelo yakhe	Ezokungcebeleka
Inyanga iveza okusha ngoMroza nengoma	Ezokungcebeleka
Usexolisile umsakazi odanse estudiyo	Ezokungcebeleka
Onyango: imfihlo ngeMTN8 nengomuso	Ezemidlalo
Umlingisi nohlelo lwamafa oluguqula impilo yabantu	Ezokungcebeleka
Sizoqhubeka la sagcina khona noCastro - Billiat	Ezemidlalo
UDube ufuna ukubuyisa abashayisibhakela abafuduka eKZN	Ezemidlalo
Bazongeniswa mahhala abazohambela ifestivali kamaskandi	Ezokungcebeleka
Wanukubezwa esemncane olingisa kwiThe Queen	Ezokungcebeleka
UNcikazi uzophungula umthwalo kuZinnbauer	Ezemidlalo
Bazonika iGalaxy ithuba lokuziveza	Ezemidlalo
UFezile usezokwethula uhlelo kuMzansi	Ezokungcebeleka
Ingqungquthela yokudodisa abafana	Ezokungcebeleka
Ngisijabulele isinqumo ngefulegi elidala lakuleli	Imibono
UMoriri usezopheka iDowns kwiMDC	Ezemidlalo
Kukuwe ukuthokoza ngemuva kokwaliwa	Ezokungcebeleka
Ukhala nge-Uyajola 9/9 uthi imkhohlisile	Ezokungcebeleka
Uzalo lushiywa ngabalingisi	Ezokungcebeleka
Ngicela ukungafundekelwa ngokuyophumula: Buthelezi	Imibono
Umgadli weZimpofana udlale wonakele umoya	Ezemidlalo
Lineme iThimba liqokwa kowokholo kumaSama	Ezokungcebeleka
Kuphinde kwabhimba kubagijimi bakuleli eTokyo	Ezemidlalo
UNdhlovu ujabulela ukubuyela kumaBlitzbokke	Ezemidlalo
UNtando uphika eyokuba yilungu lokuqina le-EFF	Ezokungcebeleka
UMcCarthy uchazekile ngomdlali omusha	Ezemidlalo
IBucs isola iSafa ngokugeja umgodi ngelomqeqeshi	Ezemidlalo
Indawo ye-Etios isithathwe yiStarlet kwaToyota	Ezezimoto
Ushintsho oluncane luyenza ihehe iSwift	Ezezimoto
UDJ Zinhle ohlwini lwabakhethekile	Ezokungcebeleka
UMakola weCity uzohola ehlezi ekhaya	Ezemidlalo
ISwallows yengeze ezinkingeni zeChiefs	Ezemidlalo
Useze wathenga imoto othunga amaphinifa	Intandokazi
ISafa ikhiphe isinqumo ngeyeMotsepe	Ezemidlalo
Izinguquko kwiMercedes-Benz E-Class	Ezezimoto
Kugcine kumlungele uBaxter enqoba okokuqala koweligi	Ezemidlalo
Kusekude phambili ngolukaNgizwe Mchunu	Ezokungcebeleka
Umlingisi ukhala ngokupotozwa engathandi	Ezokungcebeleka
UBhele akalilahlile ithemba ngoSuthu	Ezemidlalo
Likhuza ibuya kwiTV elabaxolisa emindenini	Ezokungcebeleka
Wayethi uyazidlalela wadla umhlanganiso	Intandokazi
Okwamanje ngisazohlala eFree State: Olivier	Ezemidlalo
AbeSundowns bazodlala benomunyu	Ezemidlalo
OweBanyana unesifiso sokuya kweyoMhlaba	Ezemidlalo
UBoity akumxaki neze ukuncelisa amawele	Ezokungcebeleka
Kukhalwa ngokuzimuka koxoshwe yiChiefs	Ezemidlalo
UZondo usola uParker ngokugeja	Ezemidlalo
UKhozi FM aluzehlise ku-Owen Ndlovu	Imibono
Kushubile kowesicoco seGladAfrica Championship	Ezemidlalo
Kuvuke  ithemba lokunqoba iMTN8 kuMngqithi	Ezemidlalo
Aphinde aphikwa yizinto amaProteas	Ezemidlalo
Baqopha umdlalo okhuluma ngomdanso	Ezokungcebeleka
IChiefs iqhubeke nomgqigqo omuhle	Ezemidlalo
Lizoqeqeshwa nguSikhakhane iqembu laseBay	Ezemidlalo
Bahleka bodwa kwaSuzuki bedayisa kakhulu	Ezezimoto
ITeam of Choice ifuna ukusayina uLakay	Ezemidlalo
Ubhuqwa yindlala owengoma yonyaka	Ezokungcebeleka
[IMIBONO] Sekuyisikhathi sokuthi iPirates ikhohlwe abaqeqeshi bokufika	Ezemidlalo
Ithemba lokunqoba iNFD kwiRoyal Eagles	Ezemidlalo
UMcCarthy ujabule ngokubuya kukaNtuli kuMaZulu	Ezemidlalo
Lehlile isasasa leVodacom Durban July kulo nyaka	Ezokungcebeleka
Bafuna kukhishwe uBeekay ohlelweni	Ezokungcebeleka
Sesibanjwe wuSathane kulolu gibe lwe-ANC	Imibono
I-Egypt isibambelele eshweni le-Uruguay	Ezemidlalo
Ungase uphele umdlalo Isibaya	Ezokungcebeleka
Kunobungozi ukushayela ubanjwe ubuthongo	Ezezimoto
Kuncipha izicoco ezizodlalelwa ngesizini ezoqala	Ezemidlalo
UBenni ujabule kakhulu beshaya iDowns	Ezemidlalo
Umfundisi ugxeke uDJ Zinhle ngokukhulelwa	Ezokungcebeleka
Ukhonjwa kwiPirates owayedlalela iSundowns	Ezemidlalo
USjava uphika izinsolo ngaye	Ezokungcebeleka
‘Akukho okutheni kithina nePirates’	Ezemidlalo
Ingozi edalwa ngezokuxhumana	Ezokungcebeleka
Uhlose ukubhala incwadi ngomlando wobuciko	Intandokazi
Washiya ubuthisha wangena ematekisini	Intandokazi
IM-Net yethule umdlalo omusha ozoqala ngoJulayi	Ezokungcebeleka
Amakhosi anqumele uKhuzani ugwayi katiki	Ezokungcebeleka
Umaskanda uqhudela  uNyovest ngeMabhida	Ezokungcebeleka
IDowns nePirates kwakleliswe kangcono e-Afrika	Ezemidlalo
IDowns ikhombise amava incisha umoya i-Al Ahly	Ezemidlalo
Kuyisibusiso kuPearl Modiadie ukudlala kwiRhythm City	Ezokungcebeleka
Abaqavile beSafa bazoqondiswa ubugwegwe	Ezemidlalo
Selubekiwe usuku lokufihlwa komculi wokholo	Ezokungcebeleka
Iyaheha iPeugeot 2008	Ezezimoto
Ukhiphe iCD echazela abantu ngobutabane	Ezokungcebeleka
UMokoena nenselelo kwabasha kwiSwallows	Ezemidlalo
Ufuna ukufukula abadwebi kuleli	Intandokazi
Akukho okungakhangi ngesilwane seBMW M2 CS	Ezezimoto
Ngiyafisa ibuye siyisonge kahle iThe Herd - uSparky	Ezokungcebeleka
UMkhize nethemba lokujika izinto kwiComrades nonyaka	Ezemidlalo
OwePirates uvikele uHlatshwayo ngephutha kowomkhaya	Ezemidlalo
Sichithiwe isicelo seChiefs sokuhlehliselwa imidlalo	Ezemidlalo
Abalandeli bakaProfessor bazolinda ozayo	Ezokungcebeleka
UZwane uveza induku efihlwe yiChiefs emqubeni	Ezemidlalo
Umqeqeshi ukhala ngesigcwagcwa kwi-PSL	Ezemidlalo
Izilomo emjahweni wokuziqeqesha eNanda Dam	Ezemidlalo
IPirates izibeke ethubeni lokuqhwakela kweyeDiski Challenge	Ezemidlalo
Akukapheli ngoSimphiwe nomculo	Ezokungcebeleka
OwoKhozi akasabhekani nabasemzini	Ezokungcebeleka
‘UMokotjo unakho konke okudingeka kukaputeni weBafana’	Ezemidlalo
Usezogxila emculweni oshiya uMuvhango	Ezokungcebeleka
Kusele ekomitini ngozoqeqesha iBanyana	Ezemidlalo
UBrockie ufuna ukwenza akuzele eChloorkop ngale kwengcindezi	Ezemidlalo
ObekuZalo uzolingisa efilimini entsha eqoshwa KwaZulu-Natal	Ezokungcebeleka
Abashenxe omkhulu nogogo ePhalamende badedele intsha	Imibono
Ubalisa ngemidlalo edlule uMosimane	Ezemidlalo
UJub Jub uzovulela abesifazane amacala	Ezokungcebeleka
BUKA: Imbongi yeGcokama Elisha ixolise kuSolwazi 3Seconds ngokumdelela	Ezokungcebeleka
UBaxter akayibekile eqhulwini eyendawo kaNgcobo kwiBafana	Ezemidlalo
UMakaab uphika ekaBrockie neChiefs	Ezemidlalo
Kuzocaca ngoMashi ngekusasa likaTshatha	Ezokungcebeleka
I-Downs ivale igebe esicongweni	Ezemidlalo
Ukhale ngokulinyalelwa bebhacaza kwi-relay	Ezemidlalo
Ifike nezinguquko Induna yamaGeza	Ezokungcebeleka
Umlingisi ubonga uDuma Ndlovu	Ezokungcebeleka
Kwehle iziqhomo uVan Niekerk eshiywa eTokyo	Ezemidlalo
UKarabo ukhiphe ulozolo	Ezokungcebeleka
IPirates ibuyise ithemba idlulela phambili kwiTelkom	Ezemidlalo
OwaseMtubatuba uyomela leli e-USA kwezobuciko	Ezokungcebeleka
Uphonsela abanye inselelo uDJ Zinhle	Ezokungcebeleka
'Sicela niqhubeke niseseke' - unozinti weBanyana	Ezemidlalo
AbeBafana ethubeni lokwakha isigidi ngenyanga	Ezemidlalo
ULarsen ubalisa ngomdlali osehambile	Ezemidlalo
Umucu wokuqala wowakhishwa kuma-Idols	Ezokungcebeleka
Kuhoxe abanamava kowaseNew York	Ezemidlalo
Akafuni ukuzwa ngezinkinga zeqembu	Ezemidlalo
Impi yeSafa neWits ngolukaMahlambi	Ezemidlalo
U-Ace akanankinga nokungadlali kwabo	Ezemidlalo
Kazi soneni kuhulumeni njengoba esesixova kanje ematekisini?	Imibono
Injabulo kuBroos kubuya uPercy Tau	Ezemidlalo
Siyojola size siguge nomkami: umfundisi	Ezokungcebeleka
Isikhulu seqembu lepolitiki sixwayise uSolinas ngobungozi	Ezemidlalo
UPitso ubheke abanye ukuthwala iqembu	Ezemidlalo
'Yekani ukufobela' - kuyalwa isimame	Intandokazi
Amehlo akuma-quarterfinal kwi-Euro 2020	Ezemidlalo
I-Arrows noSuthu ethubeni lokubhala kabusha umlando	Ezemidlalo
Kuduma ikhanda kuBaxter ngonozinti	Ezemidlalo
Kuzokwethulwa izincwadi zabangaboni	Ezokungcebeleka
Umgadli woSuthu uphelele kwiDowns	Ezemidlalo
Uchonywe uphaphe ngokusebenzela abesifazane	Intandokazi
U-DJ Merlon uhlanganisa i-albhamu ezophuma ekupheleni konyaka	Ezokungcebeleka
Akanalo igqubu ngeChiefs	Ezemidlalo
UZinnbauer ubona kusekhona okudinga ukulungiswa kwiPirates	Ezemidlalo
Bajabulile abanye kushiya uMpanza	Ezokungcebeleka
UNcobo ucacise ngesikhalo seSafa koweBafana neGhana	Ezemidlalo
IBloemfontein Celtic izifake obishini	Ezemidlalo
UBaxter uzonquma ngekusasa lakhe	Ezemidlalo
I-Sundowns inqobe yahlala esicongweni	Ezemidlalo
OweBarca uyaweya umdlalo neDowns	Ezemidlalo
Ngeyekhethelo iRanger Stormtrak	Ezezimoto
Kuphoxeke ezinye izikhulu ngesinqumo sokuqedela eyeKZN ABC Motsepe League	Ezemidlalo
Balanyulelwe ngabaphathi abadlali boSuthu bexoshwa	Ezemidlalo
Akuzwakali kahle ukumiswa kompimpe uRamaphosa ePhalamende	Imibono
ISundowns izibeke ethubeni elihle lokunqoba iNedbank	Ezemidlalo
I-SABC iphenya inkulumo 'ecwasayo' kaPhat Joe	Ezokungcebeleka
Ulalele umyalelo kayise oye kwiDowns	Ezemidlalo
UMngqithi akumvalile amehlo ukuba sesicongweni e-Afrika	Ezemidlalo
Abaqaphe emarenki abamatekisi bayeke abantu	Imibono
Yekani uShenge enze alethelwa kona kulo mhlaba	Imibono
Baphathi boKhozi lalelani izikhalo zabalaleli ngoba nizozisola	Imibono
Inselelo kwabesibhakela kushona uMzimasi Mnguni	Ezemidlalo
Azodobeka kalula amakhasimende kwiNissan Navara entsha	Ezezimoto
UDa Gama uthi phansi amaphaphu ngoBrooks	Ezemidlalo
Bamfuna ebuyile uSomizi	Ezokungcebeleka
ILockdown ingena eshashalazini	Ezokungcebeleka
Uvule isiteshi sokusakaza ukuze kusizakale intsha	Ezokungcebeleka
UMaKhumalo uphika eyokuba nguvumazonke	Ezokungcebeleka
Selukhishiwe usuku lokuqala komdlalo iThe Estate	Ezokungcebeleka
AmaBlitzbokke aphinde abuya nesicoco	Ezemidlalo
Ugqugquzeleke wakhipha inoni elisha uNtando	Ezokungcebeleka
UBahubhe ubonge abalandeli ngokuhlabana	Ezokungcebeleka
Usesayine kwiRoc Nation kaJay Z uKolisi - Imibiko	Ezemidlalo
Isiyadayisa iToyota Corolla eyiSUV	Ezezimoto
OwoSuthu uthandazile bewina	Ezemidlalo
Akanavalo ngokuvikela ibhande eGermany	Ezemidlalo
'ElaseMzansi kufanele liyinqobe iCaf kulo nyaka'	Ezemidlalo
Kufanele sizinuke amakhwapha: oweChiefs	Ezemidlalo
UNenzani uzishaya isifuba ngoZondi	Ezemidlalo
Kukhala esembokodo emisakazweni yaseKZN	Ezokungcebeleka
USuthu luhlulwe amagoli lubhekene nePololwane City	Ezemidlalo
Uqopha umlando kwaSABC uMarawa	Ezokungcebeleka
UKadodia usatshiswa amaphuzu okumele bawaqoqe ukuvika izembe	Ezemidlalo
Ubesebenza esitolo sokudla owoZalo	Ezokungcebeleka
Zamani kwenye indawo hhayi eBuhleni	Imibono
UManyonga umiswe iminyaka emine kwezokusubatha	Ezemidlalo
OweTop Billing kwabaphambili kuMr World	Ezokungcebeleka
Abadlali bawe-PSL bazwelana noGabuza	Ezemidlalo
IToyota Agya incane kodwa ivulekile ngaphakathi	Ezezimoto
‘Ngiphoxekile ngendlela esidedele ngayo igoli’ - Tembo	Ezemidlalo
namuhla emlandweni 5 Febhuwari	Ezokungcebeleka
Basalwa eyaseNasrec abaholi be-ANC	Imibono
Awuvulwe umngcele waseZim nakuleli	Imibono
Kubalisa nowaMaZulu ngoNgcongca	Ezemidlalo
Ufuna isinxephezelo umlingisi osolwa ngokuhlukumeza	Ezokungcebeleka
Ungeniswe esibhedlela oweBafana ozinze phesheya	Ezemidlalo
UKhumalo angase akhuhle ibhentshi	Ezemidlalo
[IMIBONO] Kuthi mangikhihle isililo ngeBucs	Ezemidlalo
Wandiswe ngeMulticab umndeni weHyundai Staria	Ezezimoto
Zibuya ngegiya eliphezulu izinhlelo zeMoja Love	Ezokungcebeleka
Olwamanqamu koweNgqwele	Ezokungcebeleka
Kuzovalwa umgwaqo uN3 isikhashana	Ezezimoto
Umakadebona unxenxa abeChiefs ngeCosafa	Ezemidlalo
IBafana inethemba kwiCosafa Cup	Ezemidlalo
Lizalelwe yinja endlini iGcokama	Ezokungcebeleka
Umlando abalingiswa bevakasha kweminye imidlalo	Ezokungcebeleka
Uhlabane ngendondo eNairobi uZaza Mokhethi	Ezokungcebeleka
I-PSL kumele yandise amaqembu: abalandeli	Ezemidlalo
Yingcindezi yonswinyo eyaphoqa uDe Klerk ukuba akhulule izwe	Imibono
UMedic uthipha iPirates kwese-Absa Premiership	Ezemidlalo
‘Nginikeza osomahlaya ithuba lokuzibonakalisa’	Ezokungcebeleka
UQhosha ususe umsindo ecula ngemiphambili	Ezokungcebeleka
Ngikujabulele ukuphinda ngiqeqeshe: Riky Rick	Ezokungcebeleka
NguBaxter ophethe ukhiye ngoSekgota	Ezemidlalo
Sebebheke ama-Olympic abagile izimanga benqoba isicoco se-relay	Ezemidlalo
Bafuna kudingiswe iCeltic egoloza no-R3 million	Ezemidlalo
‘Kwakumele alawule imizwa yakhe kangcono uPitch Black’	Ezokungcebeleka
UNurkovic uzibona ebuyela enkundleni ngenyanga ezayo	Ezemidlalo
UMcCarthy akeneme ngokuvuza kwamagoli eqinjini lakhe	Ezemidlalo
Ubuhlungu ngokubhacaza kweBhakabhaka eKapa	Ezemidlalo
Abathenwe abantu abadlwengulayo	Imibono
UKerr ukhale ‘ngomdlali’ weKaizer Chiefs	Ezemidlalo
Ligawule abadlali abahlanu izembe kwiChiefs	Ezemidlalo
IPSL ivune eyabahlanu abazongena besuka ebhentshini	Ezemidlalo
U-Ertugral weluleka isixaxa seSundowns	Ezemidlalo
OweBanyana ufisa ukudlala kwiChampions League	Ezemidlalo
ISharks izimisele ukuqeda ngeLions nezethenjwa zayo	Ezemidlalo
BUKA: UZodwa Wabantu ugonyuluke ngobunzima adlule kubo	Ezokungcebeleka
Ubhoboke ngolokudlwengulwa kwengane yakhe	Ezokungcebeleka
IChiefs ibuye ngomfutho emgonqweni weCovid-19	Ezemidlalo
Isendleleni iVW Amarok entsha	Ezezimoto
Umqeqeshi uvikele uMbappe iFrance iwashiswa ijezi kwi-Euro	Ezemidlalo
UKhoza ucacisa ngesimo sePSL ngolwe-VAR	Ezemidlalo
Wonani uBheka Mchunu kuKhozi FM?	Imibono
Kubhekwe umgadli waseNigeria kwezikaBarker	Ezemidlalo
UMaMkhize ukhuthaza imbokodo inganciki kwabesilisa	Imibono
Kushone ilungu leqembu i-Afro Soul	Ezokungcebeleka
Lungenziwa ngendlela ehloniphekile uhlelo uMnakwethu	Imibono
Isililo bephelelwa yitoho abalingisi beSibaya	Ezokungcebeleka
ISundowns iqophe umlando inqoba eseligi	Ezemidlalo
Injini ye’Downs iwubona esiswini umbango naMatsantsantsa	Ezemidlalo
Okwamabomu kulungiswa ngokwesintu, akudinge mthandazo nasibhedlela	Imibono
Akuthiwe kuphelile ngesizini ka-2019/20	Imibono
UNurkovic uyayitakula iChiefs	Ezemidlalo
UTinkler umataniswa nePlatinum Stars	Ezemidlalo
Akubukeki ukuziphaqula ngokweqile emphakathini	Ezokungcebeleka
UComitis ukhathazekile ngemiphumela yamaCitizens	Ezemidlalo
Libukeka liqhakazile ikusasa likaPhathu	Ezokungcebeleka
Bazijube basiza amabhokisa akhahlanyezwe yiCorona	Ezemidlalo
Isithengwa phesheya imikhiqizo yakhe	Intandokazi
Omama umfundisi bachaza ngezinselelo zasemabandleni	Ezokungcebeleka
I-Celtic ingase iqale isizini entsha ipatanisa	Ezemidlalo
Uyisthuphethu ngempela lo mbhemu	Imibono
Uyaziqhenya uRhoo ngeLeeds	Ezemidlalo
USemenya uqokelwe umklomelo ophezulu	Ezemidlalo
Sekuvuliwe kwabafuna ukungenela uMiss SA	Intandokazi
INkantolo ilaphe inxeba leNxeba	Ezokungcebeleka
EZOTHANDO: Ukhuluma ngomkakhe owashona njalo ebe enami	Ezokungcebeleka
UHunt uzibona ekhuza ibuya maduze ekuqeqesheni	Ezemidlalo
U-2019 uzocacisa ngozohlwitha isicoco	Ezemidlalo
!!!SIYABONGA BHELE NOMVETHE!!!	Ezemidlalo
UMicho uhalalisele iBurundi nge-Afcon	Ezemidlalo
Sifisela bonke omama usuku olubusisekile	Intandokazi
UMalesela kuyamxaka ukuzitshwa ngamaqembu	Ezemidlalo
IMaritzburg United icathamela umgadli weChiefs	Ezemidlalo
Uzolingisa efilimini uZozi	Ezokungcebeleka
I-Arrows neqhinga lokuphoxa iChiefs koweDiski	Ezemidlalo
Uthando lokujimisa luphenduke ibhizinisi	Intandokazi
UBudler uhlulwe ukungena emlandweni	Ezemidlalo
Ayishintshe isitayela iDowns: Brockie	Ezemidlalo
OweTTM udalula okuvuse umdlali	Ezemidlalo
IPirates iphendule iChiefs amathofi	Ezemidlalo
Siyoqashwa mhla kwabuya uJesu yini kanti ezikoleni?	Imibono
USemenya uzogijima u-5000m kwekazwelonke	Ezemidlalo
U-Erasmus usephupha ngesizini engcono kwi’Downs	Ezemidlalo
ISABC nemidalo ye-English Premiership	Ezemidlalo
UJordaan ubuyiselwe kwesokwengamela iSafa	Ezemidlalo
UKhoza nezinhlelo zesizini ka-2020/2021	Ezemidlalo
OweSharks usonga ngokubuyisa izinduku	Ezemidlalo
Iqeqesha nezifundiswa inhlangano yomame	Intandokazi
‘Kumele sinqobe noma kanjani eLibya’	Ezemidlalo
Isikhulu sidalula okudukise uMahlambi	Ezemidlalo
Imibuzo uKhuzwayo engekho ejimini	Ezemidlalo
Amaphoyisa aqhwaga abantu imizi yabo eMlaza	Imibono
UPhilani ubebukela kudadewabo uZimdollar	Ezokungcebeleka
Agcwalise ukwethenjwa amaBhokobhoko	Ezemidlalo
Uwuzwa ngaphakathi umdlalo alingisa kuwo	Ezokungcebeleka
Kuthuse abaningi ukushona kwenkakha yomlingisi	Ezokungcebeleka
Okungalindelwa abazifelayo ngeThe Queen	Ezokungcebeleka
Ingaphinde idlale owamanqamu iCrusaders ne-Emirates Airlines Lions	Ezemidlalo
Asithobele umyalelo kamengameli wokuvala izwe	Imibono
Ubheke amaphuzukwiChippa uTembo	Ezemidlalo
Unengwe ngabakhe bedliwa yiBaroka	Ezemidlalo
UR. Kelly nengoma engcofa abamsolayo	Ezokungcebeleka
Baqoqe amathathu kwi-Ajax	Ezemidlalo
Ushaya into ecokeme owayengakuthandi ukuba wu-plumber	Intandokazi
Ukuhlinzwa kucishe kwalimaza ikusasa kunobhutshuzwayo	Ezemidlalo
IHostela kweyesibili kwezeDStv	Ezokungcebeleka
Ngabe ihloseni ngawe indoda othandana nayo?	Ezokungcebeleka
UMutizwa ugudluze uKhenyeza emlandweni we-Arrows	Ezemidlalo
Bamangele uKhuzani ethula isiqholo esibizwa ngaye	Ezokungcebeleka
Volos: Bakubona bakubeletha ababeletha amadoda angondli	Ezokungcebeleka
Ungcwatshiwe uMpura	Ezokungcebeleka
UBaxter ucacisa ngesimo sikaKhune kwiChiefs	Ezemidlalo
Usekulungele ukusakaza oKhozini	Ezokungcebeleka
Usengalidlala futhi ibhola uBibo	Ezemidlalo
Uzodlalisa owamanqamu eCairo	Ezemidlalo
Isilomo somculi sishonelwe ugogo waso	Ezokungcebeleka
UQalinge ubheke ukuzuza olukhulu noSuthu	Ezemidlalo
Kushiya isethenjwa kwiMaritzburg United	Ezemidlalo
Bazoncintisana emunxeni owodwa	Ezokungcebeleka
Ayikho evume ukugoba uphondo komkhaya baseKZN	Ezemidlalo
Abacula umaskandi bazolingisa kuZalo	Ezokungcebeleka
Uthanda ukuvakashela izindawo zaseKZN	Ezokungcebeleka
UShenge usenza siziqhenye ngemvelaphi yethu	Imibono
Akabuye uTshatha, siyamdinga	Imibono
IChiefs ebuyela endabukweni kweyokuqedela u-2019/2020	Ezemidlalo
UMshoza usekipite noweSundowns	Ezokungcebeleka
URonaldo ususe olunye ushikishi	Ezemidlalo
UBerita ukhiphe inoni elisha	Ezokungcebeleka
Indida kunyamalala uBheka Mchunu ohlelweni	Ezokungcebeleka
IPirates isayinise umdlali weSiwelele	Ezemidlalo
UBenni ukhala ngotokoloshe waseThekwini	Ezemidlalo
Ibuthaka iWydad: Roger Feutmba	Ezemidlalo
'Osopolitiki bayanisebenzisa, baphinde banilaxaze'	Ezokungcebeleka
OweThe Qeen uzakhele izitha	Ezokungcebeleka
Useqalile ukuthungatha ikhaya elisha umdlali weMaritzburg United	Ezemidlalo
Itwetwe ngomlando weBucs eKapa	Ezemidlalo
Kungama izwe uma nginitshela ukuthi ngiqoma bani: Norma	Ezokungcebeleka
‘U-Erasmus ngimshiye ngaphandle ngabomu’	Ezemidlalo
Ibuya ngegiya eliphezulu i	Ezokungcebeleka
Sebeqalile ukupiklelana abaculi abazolwa ngePhasika	Ezokungcebeleka
UMazinyo uzobe engenamusa kwiMaritzburg	Ezemidlalo
IBafana izotholana neZambia kowobungani	Ezemidlalo
UBerita uqome ukulaxaza inkampani	Ezokungcebeleka
Sizolwa singadliwa yizembe: Ncobeni	Ezemidlalo
‘Abantu abamhlophe eNingizumu Afrika abanazwelo’ - Danny K	Ezokungcebeleka
UTinkler akeneme ngezinga labadlali	Ezemidlalo
UDrogba wodumo usewagaxa emgibeni	Ezemidlalo
Imikokotelo yemiyezane yehlisa isithunzi	Imibono
UNgizwe nabazali bakhe babungazwe omaskandi	Ezokungcebeleka
UBolt eqenjini lesizwe lebhola?	Ezemidlalo
Baphumela obala ngokuhlamuka iMabhida	Ezemidlalo
UMseleku ulaxazwe amakhosikazi amabili	Ezokungcebeleka
Sibheke isinqumo seFifa ngoDax: Kaizer	Ezemidlalo
[IMIBONO] ISafa ayiyeke ukuba yinsizwa engafuni ukwedlulwa yisiketi	Ezemidlalo
OweMaritzburg ucasulwa ukudliwa ngendlela efanayo	Ezemidlalo
I-Audi Q3 Sportback ngeyabafuna ukuhluka	Ezezimoto
Uzokwethula incwadi yakhe yokupheka	Intandokazi
IBanyana iphinde yazigwazela ibhece kwiMozambique	Ezemidlalo
UMadanon usheba umculo nokulingisa	Ezokungcebeleka
Owe-SSU uzoya kozama inhlanhla eFrance	Ezemidlalo
UDeborah udinwe abakwaNcwane	Ezokungcebeleka
Owokholo ukhaliswa yingoma yakhe	Ezokungcebeleka
Igubha iminyaka engu-85 iSABC	Ezokungcebeleka
AweSharks azoqhubeka nokuzilolonga ndawonye	Ezemidlalo
Ayikho inkinga kokwenziwe nguZimdollar	Ezokungcebeleka
Umgadli weChiefs uthushuke eBay	Ezemidlalo
I-NHI ngeke ikhethe iphela emasini	Imibono
Angimlaleli uMosimane: Komphela	Ezemidlalo
#sivalelwe noPhindile: Kuncike kithina manjeukuzivikela kwiCorona	Imibono
Baphinde baphoxeka abalandeli bakaMakhadzi	Ezokungcebeleka
Ushintsho luyenza ihehe i-Audi A4	Ezezimoto
Ungene kwaSABC engazi lutho ngeTV	Intandokazi
Usungacelwa owokucija amaProteas	Ezemidlalo
UMroza ujabulele ukufika esicongweni	Ezokungcebeleka
Babumbe iqembu labasubathi emakhaya	Ezemidlalo
POTSHOZA: Iyavuthwa eka-Andile Jali neSundowns	Ezemidlalo
UPule uxwayisa oweChiefs ngoBilliat	Ezemidlalo
Sekuyavotwa emncintiswaneni weSouth African Car of the Year	Ezezimoto
UJali usazolihlikihla eBelgium	Ezemidlalo
UKhozi FM luphenya ngoMdonso	Ezokungcebeleka
Awuthinti lutho ngoShembe umdlalo Umkhokha: Ophrojusa	Ezokungcebeleka
Liyinto engathi shu kuPitso icala leRayon	Ezemidlalo
Ubonga uyanconcoza uKhuzani ngokusekwa	Ezokungcebeleka
Uzivulele ama-B&B ezindaweni zaselokishini	Intandokazi
U-AKA uvalelisa ngeveza impilo yakhe yasesithe	Ezokungcebeleka
UMsomi uhehwe ikusasa eliqhakazile kwi-Roc Nation	Ezemidlalo
Kuphelile ngoSteyn neNdebe yoMhlaba	Ezemidlalo
Useboniswe umyeni omusha uKayise	Ezokungcebeleka
UTshatha uyaziphendulela ngokufaka ibhayibheli njalo ohlelweni	Ezokungcebeleka
UTinkler uzimisele ngokuzuza okukhulu neCity	Ezemidlalo
Kubuya ezamzukwana kwimfashini yabesimame	Intandokazi
UZidane udidwa wukuhhewulwa kukaBale	Ezemidlalo
UMahamutsa uthushuke ehlathini kungazelele	Ezemidlalo
Babuye bephoxekile omaskandi kubhuntsha umcimbi	Ezokungcebeleka
UKhehlelezi uthembisa ’iKonka’ eVerulam	Ezokungcebeleka
Umfana weKhansela ubanga ushuni kayise kwiMpucuzeko	Ezokungcebeleka
Uphelelwe wumsebenzi wabuyela kwakufundele	Intandokazi
UPhindile Gwala-Ngandu uvulelwe icala lokushaya nokulimaza	Ezokungcebeleka
USteyn ufake ingcindezi kumaProteas	Ezemidlalo
IBafana ivule i-Afcon ngesibhaxu	Ezemidlalo
UMokwena akangakhwezwa emakhanda abaqeqeshi abadala	Ezemidlalo
Volos: Sicela amaBreathalyser ensangu nezinga lewunga egazini	Imibono
OweBay ukhale ngobudedengu bedliwa	Ezemidlalo
UPitso akumethusi ukuba koweCAF	Ezemidlalo
Ngenelela Kaunda safa amaphara	Imibono
Angase akhonjwe indlela oweSundowns onukwa ngenkinga yophuzo	Ezemidlalo
USirino usekulungele ukulwela ijezi	Ezemidlalo
Kuyadingeka ukuba kuphenywe amajaji nabezobulungiswa	Imibono
UBaloyi ukhala esonozinti eMzansi	Ezemidlalo
UMngqithi ulobizela ukunqoba indebe yeMTN8	Ezemidlalo
Wadlelwa umuzi esaphaza imali yokulingisa	Intandokazi
UZozibini ungelinye lamajaji kokaMiss SA	Intandokazi
FUNDA: Odinga ukukwenza ukuze uthole amathikithi okubuka uBeyoncé noJay-Z	Ezokungcebeleka
IDowns yenze okwehlule iBafana eSudan	Ezemidlalo
UHunt asimthenanga amandla isinqumo	Ezemidlalo
Uthi igcagcele esokeni ngokudlalela ekhaya	Ezemidlalo
ULady Zamar emakhonsathini kaTamia	Ezokungcebeleka
Ubonga abantu owengoma yonyaka	Ezokungcebeleka
Ujabhile uKhuzani ngokulahlwa uMasipala	Ezokungcebeleka
UHunt namazwi athembisayo ngoHlatshwayo ofunwa yiPirates	Ezemidlalo
Impi yamazwi kwabe-PSL ngomqeqeshi	Ezemidlalo
Igcagcele esokeni koweNedbank Cup: oweMaritzburg	Ezemidlalo
Kuphinde kwabheda kwiStellies igotshwa iRoyal AM	Ezemidlalo
IPirates izithwese ijoka idlala ngokulingana	Ezemidlalo
Kushone izihlabani zomculo wamaPiano	Ezokungcebeleka
Usayingxenye yeSundowns uSirino	Ezemidlalo
ICeltic ingase ithole abaxhasi abasha	Ezemidlalo
Uqede iminjunju ngokubhala incwadi	Intandokazi
Lwandile ukhwantalala emacikweni - umculi	Ezokungcebeleka
Bafuna kubuyiswe Isibaya abangagculisekile ngeDiep City	Ezokungcebeleka
UWinnie Ntshaba nezinkundla zokucobelelana ngolwazi	Ezokungcebeleka
[IMIBONO] UBabheke woKhozi FM uyenzelela	Ezokungcebeleka
Ubhekane nobuhlungu walwa waphumelela	Ezokungcebeleka
U-AK47 ufisa ukubona oweBafana ewaqhulula kwiMaritzburg	Ezemidlalo
Akulungiswe okwenzeka kuSigiya Ngengoma	Imibono
I-UEFA isongela amaqembu ezimpunyela aqala iSuper League	Ezemidlalo
Ushintshe umlando wePSL ngamagoli owachithwa kwiBucs	Ezemidlalo
Indumezulu yowamahlaya	Ezokungcebeleka
Ungcwatshwe okwenkosi uTsepo Tshola	Ezokungcebeleka
UThinah Zungu ukhala ngabamsongelayo	Ezokungcebeleka
IDowns iqinise amathuba okuvikela isicoco seligi	Ezemidlalo
Sifuna imisebenzi hhayi izikibha	Imibono
Sifuna ukuphendula iMabhida isikhala sakwaNtombela: Zungu	Ezemidlalo
IPirates ifike zigawulwe zabekwa: Mutizwa	Ezemidlalo
Ufakela isitolokazi  umlimi wesifazane osemncane	Intandokazi
UMngqithi ugxeke onompempe bebanjwa koweligi	Ezemidlalo
UDoctor Khumalo akayiphathi eyekusasa lakhe	Ezemidlalo
Ingababophisa ingoma oBabes noMampintsha	Ezokungcebeleka
Inyakazisile esigabeni sayo iSeltos	Ezezimoto
UKhoza ucebise osegaxa emgibeni amakhokho	Ezemidlalo
Amakhosi abuyise ithemba edlala ingcwenga yebhola	Ezemidlalo
Ziningi izindawo ezidinga ukuhlanjululwa ngokwesintu	Imibono
IBaroka iqhubekile nokuphuza iChiefs inyongo	Ezemidlalo
Zinyantisa igazi izinto ezenziwa abantu besilisa	Imibono
Akawuvali umlomo uZikalala ngozime waseKZN	Intandokazi
'OweBucs neDowns ngeke ucacise ngeligi'	Ezemidlalo
USho Madjozi ufuna ukwazi indlamu	Ezokungcebeleka
UPitso uqhathwe neSundowns kweyamaqoqo kwiCCL	Ezemidlalo
OweChiefs uvikele uBaxter ’ngokuzitshwa’ kukaNgcobo	Ezemidlalo
Bakhuza abagxeka izinqumo zikaBaxter	Ezemidlalo
UKhaya Mthethwa uqiniseke eyomshado nowayenguzime wakuleli	Ezokungcebeleka
’Ushaye’ omthinte izinqa  uZodwa Wabantu	Ezokungcebeleka
[EZOTHANDO] Sishadile kodwa asikaze sihlale ndawonye nomyeni wami	Ezokungcebeleka
UKhaya ukhethe        iHouse of Zwide	Ezokungcebeleka
Ucijelwa ama-Olympic umsubathi ogila izimanga	Ezemidlalo
UKhuzani noThinah nomhlangano wabo wetiye	Ezokungcebeleka
UJub Jub uzonikela emindenini yezingane azilimaza	Ezokungcebeleka
Ngiyadumala ngobuholi be-ANC esinabo eKZN	Imibono
Umsakazi usetakula abakhubazekile njengoba kuvalwe izwe	Ezokungcebeleka
Ufisa umphumela ubuyise umdlandla	Ezemidlalo
Luxoshelwe ucansi ema-cinema Inxeba	Ezokungcebeleka
Siyaziqhenya ngawe Lalela mbali yesizwe	Imibono
Iphoxwa yinjini ne-gearbox iRenault Koleos	Ezezimoto
Ukludliwa kweTeam  of Choice kwandise ingcindezi kuTinkler	Ezemidlalo
Kwakhiwe isigungu esizobhekela izinkakha zebhola	Ezemidlalo
EZOTHANDO: Silungiselela ukushada kodwa angisaluthokozeli ucansi	Ezokungcebeleka
Ingwiji koluka Rachel Kolisi, angase avulelwe icala	Ezokungcebeleka
'Ngimuhle nezibazi zami futhi ngizithanda nginje'	Intandokazi
Iyashuba ingxabano yomrepha baKwaMashu	Ezokungcebeleka
[IMIBONO] Ake ngithele amanzi emhlane  wedada eliyiPSL	Ezemidlalo
Okufanele uzibuze kona uma kuthiwa yidla igobongo uthwase	Imibono
Umgadli woSuthu ufuna kuphenduke amatafula	Ezemidlalo
UKomphela nezinhlelo zokuqinisa udonga	Ezemidlalo
I-East Coast ingenisile endlini emnyama	Ezokungcebeleka
Masizigqaje ngomsebenzi omuhle owenziwe yiMbube	Imibono
UBaxter uphonsele uMashiane inselelo ngesikimu	Ezemidlalo
Ngithulela isigqoko amaphoyisa aseNquthu	Imibono
Kube ncane indawo kuxabana iPeople's Bae noPearl Thusi	Ezokungcebeleka
UKhenyeza ucacisa ngekusasa lakhe ebholeni	Ezemidlalo
Banethemba kubalandeli babo	Intandokazi
Izoba eyamagugu indlu kaLetta Mbulu	Intandokazi
UHlanti uzofundisa abasebancane kwiBafana	Ezemidlalo
I-SABC icela sihlonishwe isinqumo sokumiswa kukaTshatha	Ezokungcebeleka
‘Kunzima ukusakaza’	Ezokungcebeleka
Umqeqeshi akanagqubu ngoVries	Ezemidlalo
[IMIBONO] Izinguquko zeGagasi FM ziyajabulisa	Ezokungcebeleka
Ume esikoleni ukufeza iphupho kuma-Idols	Ezokungcebeleka
Agabe ngezokuphepha amaloli akwaVolvo Trucks	Ezezimoto
Uchitha eyokhwantalala kwindodakazi yakhe uyise wengoduso ka-AKA	Ezokungcebeleka
AmaBlitzbokke abheke ukuqala kabusha eVancouver	Ezemidlalo
Uvalo lokudilizwa lwamnika isibindi	Intandokazi
IChiefs ilindele isinqumo se-CAS ngolokusayinisa	Ezemidlalo
Kusuka amaphepha ngeBMW M4 Competition	Ezezimoto
Umsindo ngeSABC Summer Song	Ezokungcebeleka
UPutuma useqome owokholo emuva kokulaxaza i-jazz	Intandokazi
IPSL izokwethula inkomishi entsha yeGladAfrica	Ezemidlalo
Injabulo ibuzwa kowe-Arrows kuqokwa abadlali	Ezemidlalo
UMbuli uthi ukhathazekile Eswatini yincwadi evaliwe	Ezemidlalo
Sijabulile kumenyezelwa iSilo sethu	Imibono
FUNDA: Konke odinga ukukwazi ngezinguquko kuKhozi FM	Ezokungcebeleka
Ngabe i-ANC iyaziqhenya ngezethembiso engazifezanga?	Imibono
Imenenja icikwa yiChiefs ‘exhaphaza’ umdlali wayo	Ezemidlalo
Amaphuzu amathathu azosisindisa ezembeni: Sadat	Ezemidlalo
UZakwe nezinhlelo zokuqedela iziqu ze-IT	Ezokungcebeleka
Ngishaya amakhala ngempumelelo yeSundowns	Imibono
IChiefs izodlalela ukubuyisa ukuzethemba	Ezemidlalo
Izithembile iDistruction Boyz nge-albhamu yayo	Ezokungcebeleka
ULamola uhamba yedwa ngamagoli eKZN	Ezemidlalo
Izosongwa eThekwini isizini ka-2018/2019	Ezemidlalo
Ukhiphe incwadi engabesifazane ababulala izingane zabo	Intandokazi
Indoda idinga ukuhlonishwa ngisho ngabe kayinalutho esandleni	Imibono
Ucacisa ngezinsolo zokushada noNongcebo McKenzie	Ezokungcebeleka
Umsunguli  weHostela  uchaza ngobunzima adlule  kubona ngalo mdlalo	Ezokungcebeleka
USimbine ujabule eshiya ingwazi	Ezemidlalo
Bahleka bodwa amabhonasi abadlali beThanda Royal Zulu	Ezemidlalo
Ngizosiza abenezifo zengqondo: Shudufhadzo	Intandokazi
ISundowns izigwazele ibhece kwiBucs koweNedbank	Ezemidlalo
'Akahambe kwiSafa uJordaan'	Ezemidlalo
Alidingeki ihaba uma uziphaqula	Intandokazi
Kuvuke abalele Usuthu luqhatha iLeopards nezembe	Ezemidlalo
INissan ihoxisa ukwakha iNP300 Hardbody	Ezezimoto
OwaseKZN ungene emlandweni enqoba kuMiss SA	Intandokazi
Usebuyele emculweni umlingisi weGenerations	Ezokungcebeleka
UNtencane 'ubangwa' ngabaculi besifazane	Ezokungcebeleka
Uvalo kuhoxiswa izicelo kwabesibhakela	Ezemidlalo
Ukhonjwa kwiBaroka owoThongathi FC	Ezemidlalo
UBeekay umiselwe ukuphawula ngoMr Magic	Ezokungcebeleka
Makabhekane notwayi lwakhe uMagashule	Imibono
Kunyukile ukwebiwa kwezimoto	Ezezimoto
Osaziwayo bagxeka uMampintsha	Ezokungcebeleka
Ixhaswe ngezigidi iTeam of Choice	Ezemidlalo
Izithombe zikaBhulose zizosuswa ezikhangisweni zeMbewu	Ezokungcebeleka
Kudalulwe intengo kwavulwa ama-oda ezimoto zikagesi ama-Audi e-tron	Ezezimoto
Unwele olude Shenge, iNkosi ayisigcinele wena	Imibono
Unovalo lokubuyela emculweni	Ezokungcebeleka
UBroos akayiboni eyokuphindwa koweBafana neGhana	Ezemidlalo
Uhulumeni uzongenela kolukaphethroli	Ezezimoto
UTD Jakes ukhuza ibuya	Ezokungcebeleka
Obethula iSelimathunzi ufisa ukukhula ekulingiseni	Ezokungcebeleka
AbeRET mabashiye            i-ANC bakhe iqembu labo	Imibono
Ayicacisi ngekusasa likaRamagalela iCity	Ezemidlalo
Basadukuza ebumnyameni abanye kuKhozi FM	Ezokungcebeleka
[IMIBONO] Yizinduna eziphehla udlame kumaskandi	Ezokungcebeleka
Akafuni ukuzixaka ngokudlala kuBafana	Ezemidlalo
Bahlabane ngezinhlelo ezintsha kuSABC 1	Ezokungcebeleka
Uzimisele ngokuphakamisa uMphithi	Intandokazi
Ngabe uyashiya u-Ekstein?	Ezemidlalo
IWits ivusele uDlamini izipoki zango-2010 ihlula Usuthu	Ezemidlalo
Sekunjalo ngomcimbi kaKhuzani eMabhida	Ezokungcebeleka
Limfulathele umqeqeshi weBaroka esifuna omunye	Ezemidlalo
UHhashi no-Ebony basakaza umaskandi	Ezokungcebeleka
UVukusic uziba ekaJabu neqembu lesizwe	Ezemidlalo
Iwubukhosi i-Audi Q7	Ezezimoto
UDolly  ufakwe eqenjini leBafana Bafana	Ezemidlalo
UKhisimusi usheshe wafika kubaculi bakuleli	Ezokungcebeleka
UModric ethubeni lokuqeda ngoMessi noRonaldo	Ezemidlalo
Inkakha ibona uMcCarthy ezofeza iphupho likaZungu	Ezemidlalo
UBaxter ubona sekuntwela ezansi kwiChiefs	Ezemidlalo
Kunconywa iChiefs ngoMabedi	Ezemidlalo
ILeopards ishubise umbango emsileni idla iChiefs	Ezemidlalo
Injini yeChiefs kwiDiski nethuba laphesheya	Ezemidlalo
Usephinde wakususa futhi lokho uMasechaba...	Ezokungcebeleka
Ukhonjwe indlela kwi-Eagles uZongo	Ezemidlalo
Isikhulu silaxaze iTS Galaxy ngenxa yenkulisa	Ezemidlalo
UNgcobo uyibekile induku ebandla kwezemisakazo yomphakathi	Ezokungcebeleka
BUKA: Okuzobe kuqukethwe uhlelo lwethelevishini lukaZodwa Wabantu	Ezokungcebeleka
Wafakwa kuKarate ngamabhoklolo	Ezemidlalo
Ekugcineni iPirates iyayivuma ekaNdengane	Ezemidlalo
ISafa ifake isikhalo ngezinqumo zikanompempe koweBafana neGhana	Ezemidlalo
Izinguquko kwiRadio 2000 kushiya umsakazi	Ezokungcebeleka
Ukugula kuphazamise uMkhwane koweshashalazi	Ezokungcebeleka
UHunt usanethemba ngokuhlangana kwezinto kwiChiefs	Ezemidlalo
UManyonga uqokwe nabaphambili emhlabeni	Ezemidlalo
UMohale uchitha eyokutholelwa nguSomizi umsebenzi	Ezokungcebeleka
‘Anginanxa nokugxekwa ezinkundleni zokuxhumana’- Pitso	Ezemidlalo
Uzojabulisa abantu e-ICC uChris Tucker	Ezokungcebeleka
UCoetzee ukhuluma ngobuhlungu besizini edlule	Ezemidlalo
Bathembisene umshado u-AKA nesinqandamathe sakhe	Ezokungcebeleka
UVan Heerden ezingxoxweni noSuthu	Ezemidlalo
Akaphumeli obala ngenkontileka	Ezemidlalo
Akayikhohliwe induku yeSuperSport oweBucs	Ezemidlalo
I-United nesifiso samaphuzu aphelele kwiCeltic	Ezemidlalo
Akubhekwe nobubi bomgomo weCovid-19	Imibono
OwePolokwane akaziboni esembangweni weseligi	Ezemidlalo
Seligcwele ibhasi eliya koweSolezwe	Intandokazi
UKomphela akafuni bazithambise  koweLeopards	Ezemidlalo
USerero udingiswe unomphelo yiSafa	Ezemidlalo
UKadodia usecula ingoma ehlukile ngendali yeMaritzburg	Ezemidlalo
UThuso umele iKZN kuma-E! People's Choice Awards	Ezokungcebeleka
UJohnson akafuni ukuzwa igama ‘izembe’	Ezemidlalo
OweKhaya uncoma imfundo embonini	Ezokungcebeleka
IKia Rio iqhubeka nokuheha abathengi	Ezezimoto
Elawini likaMaGumede: Kuyadumuza ukuphuza kwabantu besifazane	Ezokungcebeleka
Isimnxenxa ngemali ethe xaxa uBilliat iSundowns	Ezemidlalo
OweWits uhlolwa elasePortugal	Ezemidlalo
Lingayekwa ithuba lokuphatha i-Afcon: Khoza	Ezemidlalo
UPhumeza nohlelo lokusiza izingane ezalahlwa abazali	Ezokungcebeleka
Ummeli kaMampintsha usegeze izandla ngaye	Ezokungcebeleka
Uyokhohlwa efile wokwamehlela indoda imthela nge-acid	Intandokazi
Kuvele induku kaMalesela ayithukusele iChiefs	Ezemidlalo
Utusa uzakwabo ngokumcathulisa	Ezokungcebeleka
ISwallows izingela uHunt omiswe yiChippa	Ezemidlalo
Ligqabukile igoda phakathi komlingisi nohlelo i	Ezokungcebeleka
OweSundowns akaphumeli obala ngokugaqela uXulu	Ezemidlalo
Uncome iHighlands Park elahla amaphuzu	Ezemidlalo
Ikhala ngenzondo    imindeni yababhubhile	Intandokazi
OwaseYadini uphika izinsolo zokuthwala	Ezokungcebeleka
IBaroka inqamule injabulo yePirates iyibamba koweligi	Ezemidlalo
Umsakazi ujikijele omunye ngamazwi	Ezokungcebeleka
Obekhuhla ibhentshi kwiBucs usezobonakala kuMaZulu	Ezemidlalo
Kwethulwe iFord Ranger Raptor eyisipesheli	Ezezimoto
Isizini yaMaZulu ivivinywe ngeDowns	Ezemidlalo
Umsindo kuvela ezithinta uTupac	Ezokungcebeleka
Ungayibona imihlola eyenzeka ebandleni laseSiphingo	Imibono
Isabelomali esizohlomulisa intsha, isimame naboselwa	Imibono
Obengumabhalane usefuye izingulube	Intandokazi
Usevuke wazithatha uMsweli woKhozi  FM	Ezokungcebeleka
Suka eduze koshayela budedengu	Ezezimoto
Umkhankaso wokubuyisa uZola 7 kwiTV	Ezokungcebeleka
IKaizer Chiefs isayinise umdlali waseGhana	Ezemidlalo
Uyabuya umdlalo wodumo iRockville	Ezokungcebeleka
Ithuba eliyingqayizivele kohlola umoba	Intandokazi
Omusha woKhozi ubhekene nokuningi ngasikhathi sinye	Ezokungcebeleka
UKhanyi unxusa uhulumeni ukuba avumele ukudayiswa kotshwala	Ezokungcebeleka
Ziqale ngesasasa iziqephu zocansi kwithelevishini	Ezokungcebeleka
Kunzima kowesifazane osesibhakeleni	Ezemidlalo
Ufuna ukubuyela ekulingiseni uZolani	Ezokungcebeleka
IToyota Hilux idayise okuzedlula zonke ngoFebhuwari	Ezezimoto
Unxuswa ukuthi abhukule uNtshangase	Ezemidlalo
IBanyana ibukise ngeMozambique kowokuhlungela i-AWCON	Ezemidlalo
[IMIBONO] Angiyiboni into esiyifundiswa wuZalo	Ezokungcebeleka
Masihloniphe abasakazi abadala nabaphethe manje	Imibono
URasta uzohlonipha noMenzi Ngubane ngomdwebo	Ezokungcebeleka
Osafufusa ukhala ngokudlelwa iculo nguZahara	Ezokungcebeleka
USolinas uxolisile ezakhe zishaywa	Ezemidlalo
ULira uhlonishwe ngonodoli ofana naye	Ezokungcebeleka
IDowns ivule izandla kwabagaqele uBrockie	Ezemidlalo
Olaxaze iFree State ukhonjwa kuBucs	Ezemidlalo
[EZOTHANDO] Ukuxabana akuhlangene nenkonzo yasekamelweni	Ezokungcebeleka
Kufezeke iphupho kowaseMnambithi oselingisa nezinkakha  kwiVula Vala	Ezokungcebeleka
Bavale imingcele phesheya bamosha izinhlelo zikaNotoane	Ezemidlalo
Ayiphoxanga abalandeli i-Cameroon ivula ngewini ekhaya kwi-Afcon	Ezemidlalo
UBenni akajahile ukungena emakethe uma sekuvulwe iwindi	Ezemidlalo
UMjosty uphonsa itshe esivivaneni	Ezokungcebeleka
Kunzima kwiChiefs emidlalweni ezayo	Ezemidlalo
Ingane iyashaywa nje kwaphela bakwethu	Imibono
IVolvo izodayisa izimoto ezihamba ngogesi kuphela	Ezezimoto
Bagadlane esidlangalaleni oJub Jub noLerato Kganyago	Ezokungcebeleka
‘Angiboni ngiyoke ngiphinde ngibuyise umcimbi wami eThekwini’ - Cassper	Ezokungcebeleka
Itiye laseNkandla emidwebeni kaRasta	Ezokungcebeleka
Izikhulu zeCeltic ziyaziqhelisa nemizamo yabalandeli	Ezemidlalo
I-Royal AM ayizithinti ngokwamukela ukususwa esicongweni	Ezemidlalo
Umsubathi wakuleli useyinyama phesheya	Ezemidlalo
IBafana iqinise idolo ibambana neZimbabwe	Ezemidlalo
Umnyango uhlanganisa amasu azosiza ngesikhathi esilahlekile	Imibono
UPitso nesixazululo ekuhlelweni kwemidlalo	Ezemidlalo
Uzimisele ukunika uRantie ithuba lesibili	Ezemidlalo
Bazohlukana neshisiwe abafuna uJali	Ezemidlalo
IVW T-Roc yiSUV edonsa amehlo	Ezezimoto
IChiefs ivulele induku kwiPirates koweDiski	Ezemidlalo
Yaba budlabha iMeya yeTheku ikhuluma	Imibono
UTinkler akazimisele ukudlala eyokuhlunga	Ezemidlalo
Ugxeka awaseKZN ngokufuduka kwabadlali	Ezemidlalo
Uthi kusekuncane akushilo uJub Jub	Ezokungcebeleka
Ubona engenza kangcono kweZimnyama	Ezemidlalo
IToyota yethule imoto entsha eshibhile	Ezezimoto
Uchungechunge iHlomu the Wife seluzoba umdlalo	Ezokungcebeleka
Ngibona Uzalo lugqugqezela ubugebengu ezweni	Imibono
Siyadumaza isimo sedolobha uMphithi	Imibono
Kuphelile ngomshado womsakazi wodumo	Ezokungcebeleka
Kuvela okuxoshe iBafana ehhotela lodumo	Ezemidlalo
Umqeqeshi weRichards Bay usongela i-Ajax Cape Town	Ezemidlalo
UMaBlerh usazogobhoza kwiRGB	Ezokungcebeleka
IBafana iphume zibekwa kwiCosafa	Ezemidlalo
Liqale kahle elikaTau kowokuhlungula iChampions League	Ezemidlalo
Uswele amazwi u-Ayanda Msweli enikwa imoto	Ezezimoto
Ingase ingabuyi iCeltic ngesizini ezayo	Ezemidlalo
Imenyezeliwe intengo yeVW Caddy entsha	Ezezimoto
Sidlala kahle, inkinga yethu amagoli: Mosimane	Ezemidlalo
Amathiphu okushayela ezindaweni ezinezibhelu	Ezezimoto
UKomphela akafuni ezakhe zizithwale	Ezemidlalo
Ujabule umqeqeshi weBucs ngabadlali bakhe	Ezemidlalo
Ubemele abasebenza emarenki kumaMetro	Ezokungcebeleka
UDani Alves ukhuza ibuya kwiBarcelona	Ezemidlalo
Yazi kabanzi ngeGEPF ungakathathi umhlalaphansi	Imibono
Izinguquko kwiBMW X3 eyakhiwa kuleli	Ezezimoto
Kukhonye amaciko aseKZN kumaSatma	Ezokungcebeleka
UTamia ungene kwasukuma yonke inkundla	Ezokungcebeleka
Kushiye abaculi abamqoka kuMabhenanyawo	Ezokungcebeleka
EzeChiefs nenselelo yokuphindiselela ’obhuti’ kwiRoyal AM	Ezemidlalo
’UKhenyeza kufanele anikwe ithuba lokuqeqesha’	Ezemidlalo
Ufuna ukuya kude oweZululand FM	Ezokungcebeleka
Ivukana likhala ngoMdingi ngokulixhopha	Ezokungcebeleka
OwoZalo nesifiso sokuyolingisa phesheya	Ezokungcebeleka
Imiklomelo koweBucs noweDowns	Ezemidlalo
Isendalini iTeam of Choice	Ezemidlalo
Uthole enye indondo uTrevor Noah	Ezokungcebeleka
OweBucs uthembisa eyamehlo kubalandeli	Ezemidlalo
Lutho ukuqhosha edla ubhedu uSgwebo Sentambo	Ezokungcebeleka
UNdlondlo ufuna ukubhibhisa isilonda seDowns ngenduku	Ezemidlalo
Kuphelile ngomshado wosaziwayo	Ezokungcebeleka
Ufuna ukusizwa yindodana kuBafana	Ezemidlalo
USikhakhane usezoqeqesha i-Eagles	Ezemidlalo
Udumaze umqeqeshi ewagaxa emgibeni	Ezemidlalo
Kuzwele nakosaziwayo kuboshwa uZuma	Ezokungcebeleka
Umfelandawonye uthi ayifakelwe izibuko eyamabhoklolo	Ezokungcebeleka
Odume kwi Pirates useyakholwa ngemuva kokuvaleka amehlo	Ezemidlalo
‘Ukushaya amagoli okweqembu lonke’	Ezemidlalo
ISA Under 23 ibhubhise iZimbabwe kowokuhlungela ama-Olympics	Ezemidlalo
Bazowubuka bhusende oweBafana asebegomele iCovid-19	Ezemidlalo
I-Caravelle ibhasi lomjolo, ithandwa ngabaningi	Ezezimoto
OwoSuthu ubonga abadlali ngemiphumela kwiDiski	Ezemidlalo
IBafana isizodlala neMadagascar kowobungani	Ezemidlalo
UTlale uvikela uBroos ngoweChiefs okhuhla ibhentshi	Ezemidlalo
Imibuzo kubonakala uMazinyo	Ezemidlalo
Kuyibhedele iRoyal AM ivala unyaka ngenduku	Ezemidlalo
‘Aqhamuka kimina amagama ozakwethu’	Ezokungcebeleka
Inkakha incoma i-Arrows ngokubuyela ebholeni layo lamzukwana	Ezemidlalo
Inceku ihlulwe wumona ngoBeekay	Imibono
UMcCarthy ujabule belungisa iphutha	Ezemidlalo
#Ezobuhle: Bayadlisa abesilisa abanentshebe	Ezokungcebeleka
Uswele amaphiko uMr Magic kuhoxa icala elamxoshisa	Ezokungcebeleka
Uzophuma eceleni kuhle kwajosaka umdlali waMaZulu	Ezemidlalo
Izinkunzi zePSL nemisiko emisha	Ezemidlalo
Iya ezikhungweni zikahulumeni uzolibona ihlazo	Imibono
Yonke into ihlangene ngomcimbi kaKhuzani	Ezokungcebeleka
Basophe ukulibuyisa idumela le-Alfa Romeo eMzansi	Ezezimoto
Unebhizinisi elithi yena  obewashela abantu izingubo	Intandokazi
Usihlalo weCity uthungatha umgadli ovuthayo	Ezemidlalo
AbakwaToyota baxhase iChiefs ngezimoto iminyaka emithathu	Ezemidlalo
Izinto zimapeketwane kuPolokwane City	Ezemidlalo
Ivulekile futhi yinhle  iLand Cruiser Prado	Ezezimoto
Sicela uKhozi FM lubuyise uLinda Sibiya	Imibono
IChiefs ayicacisi ngoKhumalo	Ezemidlalo
Uzobukwa ngoR3.6 m oweChiefs	Ezemidlalo
Isidlulile emhlabeni inkakha yomlingisi	Ezokungcebeleka
UHunt uxakwa wubuthuntu ebagadlini beziMpofana	Ezemidlalo
Ubonga abalandeli          uBig Zulu eqokwa kweyishumi	Ezokungcebeleka
UKhoza uqinisekisa ekaJele nePirates	Ezemidlalo
AmaZulu kuzoba yikhaya lami elisha: Van Heerden	Ezemidlalo
Sekuseduze kucace ngesama-Idols	Ezokungcebeleka
Isimelwe ngababili iKZN kuma-	Ezokungcebeleka
UMbuli ufuna babambe umgqigqo koweDurban Ladies	Ezemidlalo
UMasilela usazohlala kuMaZulu	Ezemidlalo
Ayaqina amahlebezi ngo-Amr Gamal	Ezemidlalo
‘AmaProteas angayinqoba eyoMhlaba’	Ezemidlalo
IPirates ihambe kahle inqoba ekuhambeni	Ezemidlalo
Uwacoshele ulwazi amaProteas kwi-IPL	Ezemidlalo
Kuphele injabulo kwabajoyine iBucs	Ezemidlalo
Ukaputeni woSuthu ufuna ezakhe zivuke zizithathe	Ezemidlalo
OweBanyana ubalisa ngeligi yabesifazane	Ezemidlalo
UTefu udalula okumenze waqoma ukujoyina elisehlathini	Ezemidlalo
Sidinga ukukhula ngokomqondo, bantu bakithi	Imibono
[BUKA] USjava utuse imvelaphi namasiko emukela indondo kumaBET	Ezokungcebeleka
Ayisayingeni ngempela ekaMashaba iSafa	Ezemidlalo
IBMW 3 Series ishunelwe abaseMzansi	Ezezimoto
Izicubu nenduku engasheshi ichithe	Ezokungcebeleka
AweDiski Challenge nenselelo yezivivinyo kubadlali	Ezemidlalo
UMngqithi uxwayisa ngobungozi bokutuswa kweSundowns	Ezemidlalo
UZalo ludiliza abalingisi	Ezokungcebeleka
Udedelwe ngebheyili umyeni kaMshoza	Ezokungcebeleka
'Sinethuba lamaphuzu kwiChiefs'	Ezemidlalo
Uzoqala ngoJuni umdlalo wakuleli kwiNetlfix	Ezokungcebeleka
Ningavumeli amantombazanyana ahambe wodwa ebusuku - T’zozo	Ezokungcebeleka
Ucasulwe ukusakazela izipoki	Ezokungcebeleka
Kuyamlimaza uKeet ukungadlaliswa	Ezemidlalo
Aluyi ndawo Uzalo: SABC	Ezokungcebeleka
UMiddendorp ubalise ngokulimala komgadli bedliwa	Ezemidlalo
UMicho uncome ukuzimisela kwezakhe	Ezemidlalo
Kuzobhekwa ezabaqotha emndenini ohlelweni olusha lakuleleli	Ezokungcebeleka
OwoKhozi uhoxe kowabesimame abasebenza ngokuzikhandla	Ezokungcebeleka
Unamaphupho amakhulu uManu WorldStar ezwenikazi i-Afrika	Ezokungcebeleka
I-Arrows izibeke ethubeni lokungena koweCaf	Ezemidlalo
Kubanjwe umoya ngabeChiefs	Ezemidlalo
Ngabe iKwaZulu-Natal ingakwazi ukuzimela?	Imibono
Uswele amaphiko uZandie nge-albhamu yokuqala	Ezokungcebeleka
Ikhombise ukugigiyela iBucs inkulumo kaPitso	Ezemidlalo
IBanyana ikhombise i-Angola ukuthi kukhala esikabani isicathulo	Ezemidlalo
Uthisha akababoni beyiziboshwa abafundi	Intandokazi
UZinnbauer ungena ezintangeni ngekusasa lakhe kwiPirates	Ezemidlalo
Izingwazi zakuleli zinikwe R10 million	Ezokungcebeleka
OweSibaya uzoshadelwa yisithandwa seminyaka	Ezokungcebeleka
UNorma Mngoma uhlonishwe namaqhawe amazwe	Intandokazi
Ishunwe kahle iFord Everest Sport	Ezezimoto
USpencer ucela abalandeli banike uBaxter isikhathi	Ezemidlalo
UBonang uthi uselinde uR500 000 kohubhuze amanga ngaye no-AKA	Ezokungcebeleka
Uma sibambisana singayinqoba iCovid-19	Imibono
Uthokozile obelingisa ekaThokozile kwiMbewu	Ezokungcebeleka
Kwethulwe iPolo Vivo yekhethelo	Ezezimoto
[IMIBONO] Safa abasakazi bekhuluma ngabo	Ezokungcebeleka
IWits ayiyishayi mkhuba eyesinqumo esilindelwe	Ezemidlalo
Osopolitiki abaphume nje kweyeCovid, bayasidukisa	Imibono
I-PSL iqinisekise olwendali phakathi kweCeltic neRoyal AM	Ezemidlalo
Iphethe no-AKA ozobe eqala oLundi iGumba Fest	Ezokungcebeleka
Injabulo kodle ubhedu kowoKhozi FM	Ezokungcebeleka
Ugqugquzela ezakhe ukaputeni we-Arrows	Ezemidlalo
IPirates isanethemba lokunqoba enye yezindebe kule sizini	Ezemidlalo
Akubhekwe umlando ngesixazululo kwaShembe	Imibono
UMasechaba uphumela obala ngokudlwengulwa	Ezokungcebeleka
Kungaphezu kwegqubu  okubangwa yi-England namaBoks	Ezemidlalo
UMcCarthy ubalisa ngomdlali ayemcelile	Ezemidlalo
ISundowns ichazekile ngomgadli wayo omusha	Ezemidlalo
Izinkinga emdlalweni ozodlala kuSABC1	Ezokungcebeleka
Ukuthanda ibhodwe kwenza wavula ibhizinisi	Intandokazi
OweSuperSport ulahle ithemba ngeseligi yeDiski	Ezemidlalo
Ukhonjwa e-Egypt umqeqeshi olaxaze iPirates	Ezemidlalo
Uwafawafa namhlanje kumaSama	Ezokungcebeleka
Indida ngekusasa lesikhulu sePirates	Ezemidlalo
Isolezwe linqobe umncintiswano iSpirit of Amarok Media Challenge	Ezezimoto
IChiefs ingase iphendule amatafula ecaleni leCAS	Ezemidlalo
UShimza uphumele obala ngokubhidlika kobudlelwano bakhe noBlack Coffee	Ezokungcebeleka
Isivumelwano sePSL neDStv sincisha abahlwempu imidlalo enohlonze	Imibono
UBroos akayifuni imibono ngesikwati seBafana	Ezemidlalo
Ukhiphe incwadi ngempilo kaNcwane	Intandokazi
Uthando lwakhiwa wukukhulela emakhaya	Intandokazi
OwoMvoti ushaywa ukuntula intuthuko	Ezemidlalo
UBhele ujabulela ithuba lokulungisa amaphutha ngeChippa	Ezemidlalo
UTembo ufuna bakhiphele isibhongo kwiRoyal AM	Ezemidlalo
‘Iningi selingithatha njengosaziwayo’	Ezokungcebeleka
Kumcasulile ukudedela iPirates	Ezemidlalo
Ugxile kwabanamava uNtseki ememezela isikwati seBafana	Ezemidlalo
UZwane ubhoboka ngesifiso seChiefs ngeChampions League	Ezemidlalo
UDJ Le Soul uvume idlozi	Ezokungcebeleka
AbaseSaudi Arabia bahosha imfe kwiNewcastle United	Ezemidlalo
UMususu ubona ezovuka ngegoli kwiChiefs	Ezemidlalo
IMaritzburg kukhondolo idayisa owokufika	Ezemidlalo
UDlamini uzoqopha umlando eshova kwiTour de France	Ezemidlalo
UKole uyakhala ngodonga lweSundowns oluntengayo	Ezemidlalo
USgqemeza akasayingeni eyokudlala emakilabhini	Ezokungcebeleka
UNolwazi uyakujabulela ukulingisa kwi-Ngane Yami	Ezokungcebeleka
I-Pirates isethubeni lokuyinqoba iligi: Da Gama	Ezemidlalo
UHunt usenethemba ngempi yokugcina	Ezemidlalo
Kuya ngamagama enkehli oSuthwini	Imibono
UMngqithi ufuna abadlali bakhe bafunde ngephutha lezitha	Ezemidlalo
UZahara ukhala ngokuphendulwa ihlaya	Ezokungcebeleka
AwaseKZN afuna amaphuzu ngezindlela ezehlukene kweyeligi	Ezemidlalo
Usefuna ukugxila kwezamabhizinisi u-Anele	Ezokungcebeleka
Uhlelo oluzoba wusizo kubasiki bengqephu baseThekwini	Intandokazi
Kunxuswa ukuthi angafakwa amathayi ebiwe	Ezezimoto
IBafana ne-England ngamanzi namafutha - Mokotjo	Ezemidlalo
Ube yiqhawe uMokotjo etakula iBrentford koweligi	Ezemidlalo
Umqeqeshi ucacisa ngezilomo kuRante noLebese	Ezemidlalo
UBen 10 uzolwela ukuwinisa iBafana	Ezemidlalo
IComoros ikhishwe ilwile kweye-Afcon	Ezemidlalo
I-DA ifuna okukaKhesari kubuyele kuKhesari	Imibono
ULights Out ugawula kwasani okuphambi kwakhe	Ezemidlalo
ISundowns iwundlalele ngewini owePirates	Ezemidlalo
ISundowns izolwela ukuthola inkanyezi yesibili	Ezemidlalo
UKatsande ulibona liphezulu elabeChiefs	Ezemidlalo
Elakuleli ethubeni lengqophamlando	Ezemidlalo
Inkakha yeBafana ikhwelezela uMkhalele kwelesizwe	Ezemidlalo
Kumthathe imizuzu ukuba isilomo uMfana kaGogo	Ezokungcebeleka
UPienaar uchaza ngokulaxaza iBafana	Ezemidlalo
Abadingeki abakhuhla ibhentshi kuma-Olympics: Bartlett	Ezemidlalo
IJoyous nomjikelezo wamadoloha amakhulu kuleli	Ezokungcebeleka
I-TS Galaxy nezinhlelo zokuyibamba kweyeCaf	Ezemidlalo
Kubukeka ezophelela kwiChiefs uMncwango	Ezemidlalo
UBrockie ubhoboka ngokungashayi amagoli	Ezemidlalo
Kunenge abalandeli ukushiywa kukaCastro	Ezemidlalo
Umsindo ngesitatimende samaphutha onondweba	Ezemidlalo
UShabba ethubeni lokuphula irekhodi likaDoctor Khumalo	Ezemidlalo
UJesse ubuya ngeRhythm City	Ezokungcebeleka
Sephukile isethembiso somshado	Ezokungcebeleka
UNcikazi ukhala ngokwenzelwa phansi yizinqumo zikanompempe	Ezemidlalo
Umaskanda udinwe wumsakazi woKhozi	Ezokungcebeleka
Abesibhakela balungisa amaphutha	Ezemidlalo
OweGalaxy ukhale ngonompempe behlulwa	Ezemidlalo
' U-Anele Mdoda akumfanele ukuba yijaji kuMiss SA' - Phat Joe	Ezokungcebeleka
Udokotela ne-EP ezophuma maduze	Ezokungcebeleka
Ukunyuka kukagesi kuzoba nemiphumela emibi	Imibono
Ezemidlalo sezaba ezomntakabani kuleli lizwe	Ezemidlalo
UMthembu ululeka ozakwabo ngobumqoka bokuheha abaxhasi	Ezemidlalo
IMaritzburg otakwini lokudlala kweyokuhlunga	Ezemidlalo
Bathembisa lukhulu nge-Amarok entsha kwaVW	Ezezimoto
UNotoane uyayihlonipha iZimbabwe esendleleni yakhe	Ezemidlalo
U-Ayanda Ncwane uphawula ngezinsolo zokujola nowokholo	Ezokungcebeleka
U-Alicia Keys uyazifela ngenoni elisha likaBabes Wodumo	Ezokungcebeleka
I-IAAF Ikuhlehlisile ukusebenza komthento ocindezela uSemenya	Ezemidlalo
Inselelo kaZuma ngekhonsathi kaKhuzani	Ezokungcebeleka
Mina anginandaba nezicoco - Komphela	Ezemidlalo
Ushiswa wugqozi kwezobuchwepheshe	Intandokazi
UThembi uchaze ngobumnandi bokuba wumzali	Ezokungcebeleka
Kubuye indodana yolahleko kwiBafana	Ezemidlalo
UZothwane uzishaya isifuba ngoshuni woThongathi	Ezemidlalo
Umele abesifazane koweNgqwele	Ezokungcebeleka
IMaritzburg isazohlala esigabeni esikhulu	Ezemidlalo
Kuvele elinye ikhono koweSoul Brothers	Ezokungcebeleka
Umqeqeshi ucikwa yinkohlakalo kwi-ABC Motsepe League	Ezemidlalo
Obengumsakazi ugxeka utshwala ngokuxoshwa	Ezokungcebeleka
UZahara ngeke alubhade kwi-Ugu Jazz	Ezokungcebeleka
Ngimbona engusomathuba uNdlovu weTop 10 yoKhozi	Imibono
URulani ugezeke igilo ngokukhuthala kwabadlali beBucs inqoba	Ezemidlalo
UFerreri uyiphikile ekaThopola ne-Orlando Pirates	Ezemidlalo
UBusiswa usezokwethula iGqom Nation	Ezokungcebeleka
Ufuna bamazi engayedwana uMaKhumalo	Ezokungcebeleka
Ucija abesifazane baseNquthu kwezokwakha	Intandokazi
Kududuzwa izelamani zosaziwayo ezisemanzini	Ezokungcebeleka
Okamaskandi uchitha eyokudayisa amagwinya	Ezokungcebeleka
Kuzocaca kule nyanga ngozocija iBafana	Ezemidlalo
Ubuyile uShota oseshintshe isitayela	Ezokungcebeleka
AmaZulu agaqele unyazi lomgadli waseTogo	Ezemidlalo
Kubhuntshe umcimbi engafiki uKabza	Ezokungcebeleka
Ubuye ngezinkani umlingisi emuva kwekhefu	Ezokungcebeleka
OweGallants uzincoma ngokuqina ukhakhayi	Ezemidlalo
BUKA: UKwesta unonge ingoma ngomshado wakhe	Ezokungcebeleka
ISafa nenselelo kuBaxter ngabadlali	Ezemidlalo
UBaxter uhlela ukwesula kwiBafana	Ezemidlalo
IChiefs ingena ezintangeni ngoKhune	Ezemidlalo
Ezothando: Ngifisa silande izingane zomyeni wami	Ezokungcebeleka
Uhlelo lwePSL oluzosiza iSundowns	Ezemidlalo
Owe-SSU ukhuthazwa wuTau ngephupho laphesheya	Ezemidlalo
UHunt ubalisa ngobuthuntu babagadli bakhe	Ezemidlalo
Umndeni kaMjik'jelwa ukhala ngeDVD eputshukile esidayisa emgwaqweni	Ezokungcebeleka
UMkabayi uthi wacishe wasilaxaza Isibaya	Ezokungcebeleka
Lizolahlekelwa amavoti leli qembu	Imibono
UZwane ubheke oweFootballerof the Season	Ezemidlalo
UZimdollar ubanjwe inkunzi eqeda ukusakaza	Ezokungcebeleka
[IMIBONO] Sengithanda ukungayiboni kahle mina indaba yale  VAR	Ezemidlalo
UParker ululeka ozakwabo ngomvuzo wokuhhewulwa	Ezemidlalo
Ushiye isigubhukane oKhozini uZandile	Ezokungcebeleka
ICaf ihlehlise imidlalo yokuhlungela iNdebe yoMhlaba	Ezemidlalo
Izintokazi ezivelele ziyomela isifundazwe nezwe	Ezemidlalo
Uza nokusha umsakazi woKhozi FM	Ezokungcebeleka
Ungagqoka uswenke noma yikuphi ngamasokisi	Intandokazi
URhulani uphika eyokuvala isikhala sikaMadisha	Ezemidlalo
ITheku emkhankasweni wokuvumbulula abanekhono	Ezemidlalo
BUKA: UTipcee ubonge abamsizile ethenga isithabathaba somuzi	Ezokungcebeleka
Ubonga ukwesekwa ngomkhaya oweMetro FM	Ezokungcebeleka
Angisoze ngisigqoke isiketi: Semenya	Ezemidlalo
Ithwasa lihlaba eyokunandisa ngamaCD	Ezokungcebeleka
Unebhizinisi elizosiza abanezinwele zemvelo	Intandokazi
Abuyise izethenjwa AmaBhokobhoko ecijela i-Argentina	Ezemidlalo
Unethemba lokuthi ubonakele	Ezemidlalo
Isakhulunyelwa phansi eyobengunozinti wePirates	Ezemidlalo
Abaculi bakamaskandi bazokhulekela uZuma	Ezokungcebeleka
Uzofihlwa ngoMgqibelo uSphuzo Sabantwana	Ezokungcebeleka
UTruter akasibhekile isicoco seligi neSwallows	Ezemidlalo
Wakhuthazwa uyise osenepulazi likamoba	Intandokazi
UBaxter unezinhlelo ngendawo kaNgcobo	Ezemidlalo
'Akukho okuhlanganisa uKelly nabasolwa ababoshiwe kwelikaMeyiwa’	Ezokungcebeleka
Akagculisekile ngadlala kweyeCAF	Ezemidlalo
EZOTHANDO: Ufuna ngimuphe uR3 000 ngenyanga ukuze sibuyelane	Ezokungcebeleka
Ingwazi yeBucs ikhala ngokuqhela kukaKhoza	Ezemidlalo
USemenya uhlulwe isikhathi sama-Olympics enqoba ku-5000m	Ezemidlalo
UCaster usaqhubeka nokulwa enkantolo neWorld Athletics	Ezemidlalo
UDladla uncoma umdlali ngokungahuduli izinyawo	Ezemidlalo
UDumi noBetusile ohlelweni olusha kuTV	Ezokungcebeleka
Uvuka ngohlelo oluzosiza abefundisi abafuna omaqondana	Ezokungcebeleka
Injabulo kowePMB ebizwa kwiBafana	Ezemidlalo
Ithuba lokuvala igebe lamaphuzu kwiDowns	Ezemidlalo
Okushaqisayo ngamacala abhekene noR Kelly	Ezokungcebeleka
Ziya ngokuba ngcono izibalo zokuthengwa kwezimoto	Ezezimoto
Luza kabi uDidi Olumashoba	Ezokungcebeleka
Ingcindezi kwiChippa yehlulwa kwiligi	Ezemidlalo
Amaciko asabisa ngokuyinyomfa	Ezokungcebeleka
Umlingisi ubejuqwa wukhwantalala	Ezokungcebeleka
Kungase kuchaye iChiefs neSundowns	Ezemidlalo
Ukhala ngobugqila bocansi uSkolopad	Ezokungcebeleka
Ezothando: Umyeni wami akangenelisi, sengisizwa abafana	Ezokungcebeleka
Abawuvali umlomo ngeKonka abezobumnandi	Ezokungcebeleka
UDyantyi ethubeni lokuhlabana ngesomdlali ovelele emhlabeni	Ezemidlalo
Kusolwa impakamo emiswa kuZalo	Ezokungcebeleka
Anoqaphela izicagogwana zamaqembu okhethweni	Imibono
Ubevele efisa ukuba kwiLockdown	Ezokungcebeleka
Usamisiwe umcimbi weqembu Iziqhaza	Ezokungcebeleka
Osolwazi abazofakazela uCaster Semenya	Ezemidlalo
Bafuna uThabooty avale isikhala sikaDJ Fresh	Ezokungcebeleka
URivaldo Coetzee angase angaholi	Ezemidlalo
Akulula ukuthola ijezi kwiDowns: Mshishi	Ezemidlalo
UMosimane uncoma inkulisa yeSundowns	Ezemidlalo
Iqhinga likaBroos neBafana kweyokuhlunga	Ezemidlalo
AboZalo baqinisekise amahebezi ngabalingisi	Ezokungcebeleka
OweChiefs Ukhathazwa abamgxekayo	Ezemidlalo
Sekuqalile ukuvota kowoKhozi FM	Ezokungcebeleka
Bekunzima koseyinxusa kwezobuchwepheshe	Intandokazi
Ziyawushaya koweMafikizolo nowakwakhe	Ezokungcebeleka
Bazosina bededelana abesifazane abacula i-jazz	Ezokungcebeleka
U-AKA ugeqa amagula ngokwenzeka kushona ingoduso yakhe	Ezokungcebeleka
UKeet uvuma eyokweqiwa yijezi leBafana ngenxa ka-Itu	Ezemidlalo
Ugu lulindele izinkulungwane koweJazz	Ezokungcebeleka
Ingwadla kuHenry noHazard eRussia	Ezemidlalo
Usedlulile emhlabeni uMshoza	Ezokungcebeleka
‘Ukunakekela umzimba ikona okungenze ngancipha’ - Sophie Ndaba	Ezokungcebeleka
Ubone afike ngayo uLarsen exoshwa kwiChippa	Ezemidlalo
Usuqalile umshikashika weChampions League	Ezemidlalo
Uthembise isithandwa sakhe umshado kweyobumnandi	Ezokungcebeleka
Akazobhuquza ekhaya ophelelwa ngumsebenzi	Ezokungcebeleka
Senza okuphambene nemithetho eyishumi yobuntu bomuntu	Imibono
Kubhede ekugcineni koweNdebe yoMhlaba kwiBelgium	Ezemidlalo
'Sisendawonye nomkami kodwa asisathandani : Andile Jali	Ezokungcebeleka
Imidlalo yeSABC isizobonwa naphesheya	Ezokungcebeleka
Uthakasela ithuba lokulingisa kwi-Unmarried	Ezokungcebeleka
Iqine njengensimbi yaseJalimane iHyundai Santa Fe	Ezezimoto
Ayimkhathazi 'eyokudutshwa' kukaSithebe woSuthu	Ezemidlalo
OwoThando Nes'thembu usengumculi	Ezokungcebeleka
Ubonga isimangaliso soMdali esinda uMaster KG	Ezokungcebeleka
Buka: IToyota GR Yaris entsha igxuma njengonogwaja	Ezezimoto
Utshwala bulibulele izwe sinezibotho nemilutha	Imibono
Abadlali beBanyana bazoklaba aluhlaza	Ezemidlalo
Sekuphelile phakatthi kweChippa United no-Eymael	Ezemidlalo
UMbappe ushaywe ngesithende koweFifa	Ezemidlalo
Uqokwe ngabeSony Music uMfana kaGogo	Ezokungcebeleka
IChiefs inombele ngeSwallows yahlala emhlane kwi’Downs	Ezemidlalo
UShamsi uveza okwenyusa ifomu yakhe	Ezemidlalo
Ushiye isigubhukane kwaSABC	Ezokungcebeleka
Isaya kude impi yesicoco seligi: Tembo	Ezemidlalo
Kushode ozogadla phakathi komsakazi nomculi	Ezokungcebeleka
Bancome ukuhlukana ngokuthula kosaziwayo	Ezokungcebeleka
IMaritzburg itakule iKZN kwiDiski Challenge	Ezemidlalo
Uxoshiswe okwenja umculi kamaskandi emcimbini	Ezokungcebeleka
Kuzoba nzima ukuphila ngaphandle kukamama: umlingisi	Ezokungcebeleka
Bagcwalise inkundla kuMlazi Picnic	Ezokungcebeleka
Kukhona okusina kujeqeza umgadli wePirates	Ezemidlalo
Akanavalo lokuthi angase angaqashwa ongumlandeli we-EFF	Ezokungcebeleka
UMotlanthe uqokwe njengebamba esihlalweni sesikhulu esiphezulu	Ezemidlalo
Uzithintele izibonkolo uNgizwe komaskanda	Ezokungcebeleka
[IMIBONO] Sekunongwe namanga ngoba umfo kaMasinga esethule	Ezemidlalo
Iphenduke ihlaya iChiefs ikhishwa kwiNedbank Cup	Ezemidlalo
UMasuta ujabule ngabeLeopards	Ezemidlalo
UVilakazi ufisa ukuthola indawo kwiBafana	Ezemidlalo
UMokoka kubhekwe enze into yamehlo kwi-IAAF	Ezemidlalo
Ifika iphelele iLexus IS	Ezezimoto
Ithandwa kufanele iToyota Fortuner	Ezezimoto
Udlule ebunzimeni umethuli weNyan Nyan	Ezokungcebeleka
Uvalo ngejezi ‘elisha’ leKaizer Cheifs	Ezemidlalo
Imthinte kwamancane uProverb intsha yaseKZN	Ezokungcebeleka
UThinah uthengele ingoduso unyanyavu	Ezokungcebeleka
Ufuna ukwenza iBafana isitebhisi	Ezemidlalo
Intaka ibekelwe amazolo kwi-Arrows naMaZulu kwiDiski	Ezemidlalo
Ubhale ibhuku ngomlando wamaqhawe	Intandokazi
USenong nethemba lokuketula amatafula	Ezemidlalo
Usola imfundo ngabadlali abantulayo	Ezemidlalo
Likhulu ithemba  kwaMitsubishi ngeXpander	Ezezimoto
Umasipala uphushela ngaphandle abakuleli ekuhwebeni edolobheni	Imibono
IChiefs neSundowns kweyokushintshana ngamanxele	Ezemidlalo
Iduma kamnandi iBMW M440i xDrive Gran Coupé futhi iyashesha	Ezezimoto
Iyaziqhenya iMoja Love ngezinhlelo	Ezokungcebeleka
UKomphela namazwi enduduzo ezakhe zinqoba	Ezemidlalo
UMthandeni noKhuzani abayi emqhudelwaneni weSigiya Ngengoma	Ezokungcebeleka
Ukuba yintandane kumgqugquzele  wasebenza kanzima	Intandokazi
Ziningi izifundo esizithola empilweni kaRichard Maponya	Imibono
Izobukwa ngomta kabani bodwa iNdebe yoMhlaba yoMbhoxo	Ezemidlalo
I-TS Galaxy imlandele amava uDa Gama	Ezemidlalo
Kuhlehliswe umdlalo ngenxa yeCovid-19	Ezokungcebeleka
Kuzowinwa imoto iGagasi FM ligubha iminyaka engu-13	Ezokungcebeleka
AmaZulu aweze iSundowns ehlulwa	Ezemidlalo
Kunzima oweSiwelele enqaba ukuxola	Ezemidlalo
OweDurban Gen emdlalweni okhuluma ngeLembe	Ezokungcebeleka
Umbango ngelomcimbi weGcokama	Ezokungcebeleka
UNGALISHOVA NOMA USUKHULILE   IBHAYISIKILI	Intandokazi
Akaziwa ukuziphi izinkalo oweMaritzburg	Ezemidlalo
Kutuswe izeluleko nobuciko bukaBra Willie	Ezokungcebeleka
Waze walibulala izwe uhulumeni sibhekile	Imibono
INingizimu Afrika ihlonipha uRebecca	Ezokungcebeleka
I-VW isenza ucwaningo ngezimoto zikagesi kuleli	Ezezimoto
USolinas ubalisa ngoMolangoane	Ezemidlalo
Amaciko ethubeni lokuhlomula	Ezokungcebeleka
BUKA: UTrevor Noah usezoba nohlelo kuNetflix	Ezokungcebeleka
Kwehle izihlathi kubalandeli iChiefs ishaywa yiTS Galaxy	Ezemidlalo
Kusenzima ukukhuluma ngeChiefs - Hadebe	Ezemidlalo
Umsakazi weMetro FM usekulungele ukulingisa	Ezokungcebeleka
Uhlaba eyokupaka ibhasi kwiChiefs	Ezemidlalo
USjava usongelwa ngabaseSwatini	Ezokungcebeleka
UDu Plessis ubuyise ithemba enza ezibukwayo kowaphesheya	Ezemidlalo
Uqwaqwade osomabhizinisi	Intandokazi
Akazimisele ukubuyela kwi-Absa Premiership	Ezemidlalo
Sikhonjwa kwiPirates isiqongqwane se-Arrows	Ezemidlalo
UMcCarthy akafuni ezakhe zibe wumlilo wamaphepha	Ezemidlalo
USewabeka emgibeni amakhokho u’OJ’	Ezemidlalo
BUKA: Liphume lihlehla Igcokama eMabhida	Ezokungcebeleka
Usuthu ethubeni lokusinda ezembeni	Ezemidlalo
Akabonwa nangokhalo emafeni kaHHP uLerato	Ezokungcebeleka
Injabulo kuThembisa oselingisa kwiSibaya	Ezokungcebeleka
Okwethu wukuvikela isicoco: Bangaly	Ezemidlalo
Kuyinkinga ukungazi ngesintu, isiko nomlando	Imibono
Intukuthelo namazwi ayiziswana iDowns ishaywa yiBaroka	Ezemidlalo
UBenni weseka iChiefs ehlaselwe iCovid-19	Ezemidlalo
Zinhle izindaba umsakazi woKhozi FM embesa	Ezokungcebeleka
Izophinda iMsinga Driftkhana	Ezezimoto
IBanyana iyivule ngewini imidlalo yeCosafa Cup	Ezemidlalo
‘Abekho abadlali abazohamba kwiSundowns mahhala’ - Pitso	Ezemidlalo
Angiyiboni iChiefs iqeda kwiTop 8: Pollen Ndlanya	Ezemidlalo
Kuphelile nge-Avanza,  iRumion edlisayo manje	Ezezimoto
Kudlule iSenegal neGuinea kuGroup B	Ezemidlalo
UZodwa Wabantu uphezu kwezinhlelo zokuyonandisa eZimbabwe	Ezokungcebeleka
Kuhambe phambili uBabo kowezindondo zeSava	Ezokungcebeleka
Uzifake enkingeni ngesikimu uSolinas	Ezemidlalo
U-Grobler ujabhiswe ukungashayi amagoli awu-20	Ezemidlalo
Ungoti nezeluleko ngezangaphansi	Intandokazi
Amakhosi anengcindezi koweLeopards	Ezemidlalo
U-Emtee uthi usehlukene nezikaFaro washiya phansi nezidakamizwa	Ezokungcebeleka
Uchwepheshe weluleka ngezinhlobo ze-make up	Intandokazi
UNandi uzobadida ngengqephu kwiBET	Ezokungcebeleka
Usexoshe abesebenza nabo uBonang	Ezokungcebeleka
Ngabe uqinisile noma uyabhuqa umqeqeshi weNigeria?	Ezemidlalo
Amakhosi aqhubekile nokuba yinhlekisa	Ezemidlalo
Asivele sibadudule ngesiZulu abasithengisela imikhiqizo	Imibono
Indaba yoR350 yinhle kodwa...	Imibono
Uzimisele ngokushintsha izinto kwelaseMphithi	Ezemidlalo
UHunt ukhathazekile ngokuzokwenzeka kowoSuthu	Ezemidlalo
Ufuna izingxoxo ngoJantjie ziphothulwe	Ezemidlalo
IBafana izibeke esicongweni inqoba	Ezemidlalo
Uzakhele udumo ngokudayisa u-ice cream ohlukile	Intandokazi
Umafungase woKhozi uyicabile indlela yabesifazane kwezokusakaza	Imibono
UManqele uyivale           ngohlelo lukaKhuzani	Ezokungcebeleka
UTshatha uhlonishwe kumaSatma	Ezokungcebeleka
Ibuyele ekhaya nephuzu iChiefs ibanjwa yiGalaxy	Ezemidlalo
Isililo ngabe-netball abashone engozini yebhasi	Ezemidlalo
UNtseki ucacise ngokubiza uKhune esikwatini seBafana	Ezemidlalo
Umsindo kuxoshwa isilomo somsakazi	Ezokungcebeleka
Ngiyalwesaba usizi oluza nobuchwepheshe be-4IR	Imibono
Ukhamba lufuze imbiza kuMcCarthy weChiefs	Ezemidlalo
Ayazwakala amandla eGolf GTI TCR	Ezezimoto
OwaMazulu usho akananazi ngendebe	Ezemidlalo
Uzifake obishini  uZodwa Wabantu engafiki emcimbini	Ezokungcebeleka
[IMIBONO] IChiefs icijwa impuphu nephini elivuma zonke	Ezemidlalo
Ingase inyuke ngamandla intengo kaphethroli nodizili	Ezezimoto
Kuxwayiswa izinkunzi ngokuthi azigawule zibheke kwiNedbank Cup	Ezemidlalo
Usinde kukubi umaskanda engozini yemoto	Ezokungcebeleka
Umsakazi weVuma FM ukhonjwa kuMuvhango	Ezokungcebeleka
‘Akatholanga mali kumasipala uCassper’	Ezokungcebeleka
UMampintsha uphendula izinsolo zokweba ibheshu likaNgizwe	Ezokungcebeleka
'Sizoluxazulula maduze olukaBonang neSARS'	Ezokungcebeleka
Bazobanjwa ngohlelo lwe-TV abajolayo	Ezokungcebeleka
AboMnakwethu bazohlangana ohlelweni  oluyisipesheli	Ezokungcebeleka
Bayavutha bhe abalandeli beSiwelele	Ezemidlalo
Kuzocaca ompetha kowethu neRoyal AM: oweSekhukhune	Ezemidlalo
USgwili usephila ngokuzidayisela amaCD emgwaqweni	Ezokungcebeleka
AbakwaBMW bazama ukuvusa iGusheshe	Ezezimoto
Uhlaba ukunethezeka kwabadlali kwiPSL	Ezemidlalo
OweBucs usinde ecaleni lokudlwengula ingane (15)	Ezemidlalo
OweDowns ujabule eqokelwa kweyePSL	Ezemidlalo
Kuyaphela ngohlelo olukhonjiswe iminyaka kwiSABC2	Ezokungcebeleka
UKelly noZandie baseyinkukhu nempaka	Ezokungcebeleka
Kuzodala izinkinga ukuhlala kwezingane emakhaya	Imibono
Ubaphonsele inselelo ababekwiBanyana	Ezemidlalo
Ukhala ngabagxambukela ezindabeni zakhe owohlelo uMnakwethu	Ezokungcebeleka
OweGalaxy ubona iDStv Diski Challenge izokhiqiza abanye oBrooks	Ezemidlalo
IMercedes-AMG E53 Cabriolet ishayisa ngamahloni	Ezezimoto
‘Ziyabonakala izithelo zeMDC’	Ezemidlalo
Wanhlanhlatha uMtaka ephawula ngoMugabe neZim	Imibono
Inkunzi emdwayidwa yeChiefs ikhala ngabaqeqeshi kuMakhosi	Ezemidlalo
Umaskanda wexwayise abahleli bemicimbi emkhulu ngabo	Ezokungcebeleka
UKhuzani ucasule uNtencane noMroza	Ezokungcebeleka
UDrake uchitha imibiko yokungondli indodana	Ezokungcebeleka
Uphika eyokutheza abadlali beDowns	Ezemidlalo
Yangiphatha kabi eyokuthi ngithandana no-Ayanda: Percy	Ezokungcebeleka
‘Kuyajabhisa ukuthi ngabesifazane abakhala ngendlela engigqoka ngayo’	Ezokungcebeleka
Banekele izwe amahlazo osaziwayo ababethandana	Ezokungcebeleka
Ihlale obala inselele yokuvala izikhala zabagadli beDowns	Ezemidlalo
Uzalo seluvele lwaphenduka indavundavu	Imibono
IMaritzburg nethemba lokuvika izembe	Ezemidlalo
I-ASA nezinhlelo zokuvala ihlazo elenzeke kuma-Olympic	Ezemidlalo
Ukhonjwe indlela kwiKaya FM u-Unathi	Ezokungcebeleka
Ujabule uSbahle kuhoxa elokushayela budedengu	Ezokungcebeleka
Umlingisi weMbewu uyiphila ngempela eyobungoma	Ezokungcebeleka
UQhosha uphonsela omaskanda inselelo	Ezokungcebeleka
Kuqopheke umlando kuqokwa uSiya Kolisi	Ezemidlalo
IRoyal AM isithenge ubulungu beCeltic	Ezemidlalo
Iphunyuke kunzima iChiefs kwiMagic	Ezemidlalo
OwoSuthu ukhala ngabanomona	Ezemidlalo
Ucela ukwesekwa aboSuthu umqeqeshi osenyamanambana	Ezemidlalo
ISwallows ibheke ukukhipha ishoboolo ngeChiefs koweDiski	Ezemidlalo
Khohlwa iGR Yaris uma usacabangela umndeni	Ezezimoto
Abalingisi abasha bazoshisisa iDurban Gen	Ezokungcebeleka
Akayingeni eyokuya emicimbini amenywa kuyona	Intandokazi
UMweene akanamona ngonozinti ovuthayo	Ezemidlalo
Umqeqeshi uqhosha ngonuka iqaqa kwiPirates	Ezemidlalo
UJali angase abuyele phesheya	Ezemidlalo
URobbie Jnr uthembisa okuhlukile kunoyise	Ezokungcebeleka
OweRoyal AM akaliboni elizovimba iSundowns kweseligi	Ezemidlalo
Ulobe incwadi ohlekwa ngobushimane	Intandokazi
UPitso ukhala ngeshwa emapalini	Ezemidlalo
Abakhuzwe asebechukuluza abanye  ngobuhlanga ngoZuma	Imibono
U-Hunt akafuni bayidelele iSimba ekuhambeni	Ezemidlalo
Injabulo koweSithembiso eqokwa emikhakheni emqoka	Ezokungcebeleka
IChiefs kuthiwa imfuna uthuli uBuhle Mkhwanazi	Ezemidlalo
Akazenyezi ngokukhubazeka kwakhe	Intandokazi
UMcCarthy uphakamisa unozinti wezakhe kwabavelele	Ezemidlalo
OweSafpu ushaya amakhala ngecala likaRamagalela	Ezemidlalo
Olunye uhlangothi ngabomdabu waseNdiya efilimini yaseThekwini	Ezokungcebeleka
Thina eMsinga amanzi selokhu sawagcina ngoDisemba	Imibono
ISuperSport ihlanganise izitha ezimbili	Ezemidlalo
‘Ngilethwe emhlabeni ukushintsha umaskandi'	Ezokungcebeleka
Useziphilisa ngamaqanda uZodwa	Ezokungcebeleka
Amaciko aqungele ilanga eyofuna isikweletu	Ezokungcebeleka
Umlandeli usola ubuholi beChiefs ngokubajwayeza nezimbangi	Ezemidlalo
Isayine esitebeleni                   sase-USA iJoyous	Ezokungcebeleka
Sidlale umbhedo oyidlula yonke: Hunt	Ezemidlalo
Baxoshwa yisikhonzi senkantolo abekwaito	Ezokungcebeleka
OweTTM uthembisa okugcono kwiPSL	Ezemidlalo
Unyaka wokuba matasa kuShekhinah	Ezokungcebeleka
Umlando iBaroka izifaka kowamanqamu	Ezemidlalo
IPirates icacisa ngekusasa likaHappy Jele oshikishayo	Ezemidlalo
IBafana idinga uTau osefomini - Mokwena	Ezemidlalo
Ukhombisa ukungahleleki uhulumeni ekunqandeni ubhubhane	Imibono
UMgqumeni wayecindezelwa oKhozini- uNgizwe	Ezokungcebeleka
Kuqeqeshwa abashayeli bama-4x4	Ezezimoto
Ukhululwe wabuyela ekudanseni	Intandokazi
Kuningi okujabusila uKomphela yize eshayiwe	Ezemidlalo
Akenelisekile ngokwabelana ngephuzu neWydad uMosimane	Ezemidlalo
Usebusiswe ngendodakazi oweMafikizolo	Ezokungcebeleka
UMampintsha usolwa ngokugweva nemali	Ezokungcebeleka
Iyavuthwa eyokungenisa kweLembe kweyeSibaya	Ezokungcebeleka
Alikhuphule kakhulu izinga kulokhu Amageza	Ezokungcebeleka
Ukhwantalala lucishe lwamfaka egodini umculi	Ezokungcebeleka
IVW Kombi yimoto yawo wonke umuntu	Ezezimoto
Uzohlonishwa ngakubo uBahubhe	Ezokungcebeleka
ILotto ngeke isathenjwa	Imibono
Ukuthola ingane kumenze wanciphisa ebumnandini	Ezokungcebeleka
OweBafana ufuna ukududuza isizwe	Ezemidlalo
UDe Sa uzowubuka engaphandle oweEgypt neCameroon	Ezemidlalo
Sikhuza ibuya isilomo soZalo	Ezokungcebeleka
Bathembisa okukhulu ngefilimu osomahlaya	Ezokungcebeleka
Iqiniso malingafihlwa, uhlulekile uRamaphosa	Imibono
AmaZulu agaqele obengumgadli wePirates	Ezemidlalo
Omaskanda baveze usizi abebenalo	Ezokungcebeleka
Izwe liyoba ngcono mhla salimela iqiniso	Imibono
Ubiza abesifazane abamnyama kwezemali	Intandokazi
Ukufundele ukuba ngumfundisi owoZalo	Ezokungcebeleka
AmaZulu agweme ukuphoxeka ebuya selishona	Ezemidlalo
Kusacwebe iziziba ngolwePSL neRoyal AM	Ezemidlalo
OlweSekhukhune nePolokwane lubuyela enkantolo	Ezemidlalo
Ugqamise ithalente elisha kwi-albhamu	Ezokungcebeleka
Udida abaningi odweba umzimba sakugqoka	Ezokungcebeleka
Bayabuya ekhefini uDineo noLerato	Ezokungcebeleka
UNtseki ubona uTau eseyilungele iPremiership	Ezemidlalo
Usekhonjwe indlela uNtseki kwesokuqeqesha iBafana	Ezemidlalo
Kudlisa okwesintu emicimbini yanamuhla	Ezokungcebeleka
USolinas akesabi qembu kwawePSL	Ezemidlalo
OwoSuthu ulobizela indawo yesibili kwiligi	Ezemidlalo
'Kuzolimala abalandeli ngasengozini yezembe'	Ezemidlalo
Izinto ezingicika kuthi angihayize	Imibono
OwamaBhokobhoko ufuna kunikwe abadlali ithuba	Ezemidlalo
Aseqhathiwe azodlala kweyeCAF	Ezemidlalo
U-Ellis ujabulela inselelo yeNetherlands	Ezemidlalo
Usazoba khona umcimbi kaShekhinah wembokodo	Ezokungcebeleka
Siluleme isilomo kwalimala abanye kwiChiefs	Ezemidlalo
OwoZalo usatshiswa ngababukeli	Ezokungcebeleka
UBonang uzophatha okaMiss SA futhi	Ezokungcebeleka
Ngibonga uMntwana ngokusifundisa ngomlando	Imibono
ISharks isonga ngokuphoxa iLions kwiSuper Rugby	Ezemidlalo
[EZOTHANDO] Nginesikhwele umkami uzosebenza nowayeyisoka	Ezokungcebeleka
‘Ngijabule ngokusebenzela iGagasi FM’	Ezokungcebeleka
Amaciko azinikele ukulwa nendlala kokaMandela	Ezokungcebeleka
Uya koweBucs ezethemba owamaCitizens	Ezemidlalo
Akananxa okhonjwe indlela kwiSundowns	Ezemidlalo
UMaYeni noMseleku baphefumula ngezinsolo zokuhlukanisa	Ezokungcebeleka
Bashayana ngamakhanda ngoBuselaphi	Ezokungcebeleka
Ithemba kubuya ibhande lebhokisa elalebiwe	Ezemidlalo
UNyirenda utusa iPirates kweyeCAF	Ezemidlalo
IBlack Panther iyimpendulo yesikhalo	Ezokungcebeleka
Ugcine ekhethe umculo umphaquli osemncane	Ezokungcebeleka
Owesifazane (25) ophethe amapulazi amabili emfuyo	Intandokazi
Lukhuza ibuya uhlelo lwesithembu sikaMseleku	Ezokungcebeleka
UBaxter uxolisile ngokuphawula budedengu ngokudlwengula	Ezemidlalo
Uhehe inqwaba umcimbi weGTI 8 on Tour	Ezezimoto
Bafundisa ngokuphatha imali nobungozi bezikweletu	Intandokazi
Ulujabulele uhlelo lwasekuseni uFelix	Ezokungcebeleka
IBafana iphelile yinhlamba eTunisia	Ezemidlalo
Igcokama Elisha liphika isandla kwekaMzukulu oKhozini	Ezokungcebeleka
Kuyadlisa ukuzithanda ngezokubukuda	Intandokazi
Akenze ngokubona kwakhe uBaxter: Micho	Ezemidlalo
Umjikelezo kaDon Laka neSoul Brothers	Ezokungcebeleka
Abasakazi bazowubulala USgiya Ngengoma	Imibono
UJohnson nomsebenzi onzima	Ezemidlalo
Sebewosomabhizinisi abahlanganiswa yitiye	Intandokazi
IMaritzburg Unitedisivumile ukudayisa uRusike	Ezemidlalo
Iqokiwe imoto yonyaka u-2021	Ezezimoto
Kusolwa ukhwantalala silaliswa esibhedlela isilomo seGagasi FM	Ezokungcebeleka
Bahubhane esteji bebanga ingoma	Ezokungcebeleka
Isikhulu seBaroka asizimisele ngokuma endleleni yesilomo seqembu	Ezemidlalo
Benzenjani abangaphezu kuka-35?	Imibono
Uhlelo lokugwema izingozi kubadlali	Ezemidlalo
U-Erasmus uyazisola ngokudlala eMzansi	Ezemidlalo
ISundowns iqhubekile nokuzisondeza nesicoco seligi	Ezemidlalo
Umbango kaMjosty ngomcimbi Uvukile	Ezokungcebeleka
Akayi ndawo uZola kwiDiepCity	Ezokungcebeleka
Uzidonsele amanzi ngomsele uDJ Zinhle 'ebuyelana' no-AKA	Ezokungcebeleka
Uzoshubisa izinto kwiSono uZola Nombona	Ezokungcebeleka
Injabulo uZama enqoba ama-Idols	Ezokungcebeleka
Abakuleli abawuvali umlomo ngemoto yakwaBajaj 'ecoshwa phansi'	Ezezimoto
Basengozini yezembe abalizwa ngendaba ijezi	Ezemidlalo
Kuwe umuthi omkhulu emsakazweni	Ezokungcebeleka
UJosephs uzosebenzisa amava ukunqobela Usuthu izicoco	Ezemidlalo
Osaziwayo banxusa ukuphepha nokuthandana ngala maholidi	Ezokungcebeleka
Ukukhula kweDowns nenselelo kubaphathi	Ezemidlalo
Nginenkinga yotshwala: Zodwa Wabantu	Ezokungcebeleka
UNotoane uncoma isenzo sikaBaxter	Ezemidlalo
Umculi (15) wakuleli umenywe phesheya	Ezokungcebeleka
Washiya ezobudokotela efuna ukushayela amabhanoyi	Intandokazi
Uzosebenzisa i-United njengesango lokungena kwiBafana	Ezemidlalo
USuthu balugabisele ngelinonile	Ezemidlalo
Owe-Idibala ezingxoxweni nenhlangano yabaphila nesifo sokuwa	Ezokungcebeleka
UJacinta noZola 7 bahlela ukuba nohlelo lwethelevishini	Ezokungcebeleka
I-Wits ivule izandla ngofunwa yiBucs	Ezemidlalo
ULady D ugubhe olokuzalwa nenjejane ewu-200	Ezokungcebeleka
Uqambe ingoma ngokwenzeke kuye owama-Idols	Ezokungcebeleka
Uyazihlupha ngokunakekela ezikhubazekile	Intandokazi
Umbhukudi wakuleli ukhale ngokushisa kwamanzi eTokyo	Ezemidlalo
ILiverpool iqala eyokuvikela iPremier League ngeLeeds United	Ezemidlalo
Iyaheha iHonda WR-V	Ezezimoto
Uyaziqhenya ngasebekwenzile kwiHighlands	Ezemidlalo
Siyiqaqa kanjani ingqondo yengane, ukufezekisa inhloso yokuba nsundu?	Imibono
USemenya uhlukene nomqeqeshi wakhe	Ezemidlalo
‘IChiefs ayikaze ikhulume ngoTalent’	Ezemidlalo
Kubalulekile ukushintsha isondo ngendlela efanele	Ezezimoto
Akakaqokwa ozokwengamela amaqembu kaMjik’jelwa	Ezokungcebeleka
Iyakhuphuka intengo yamaphathi ezimoto	Ezezimoto
Angase amenyezelwe ngelizayo oweBafana	Ezemidlalo
Lusaya kude udaba lombango weRoyal AM nePSL	Ezemidlalo
UKhathaza usezodala enye inkathazo kuZalo	Ezokungcebeleka
IDistruction Boyz kumaMTV Europe Awards	Ezokungcebeleka
'Angazi ngokusayina kukaLebo kwiChiefs'	Ezemidlalo
Usekubhaceni uMshoza okuthiwa ubanjwe oqotsheni ejola nephoyisa	Ezokungcebeleka
UProdigal useqeqesha abagijimi abasafufusa	Ezemidlalo
Kudumale umqeqeshi weBafana ngoMadisha	Ezemidlalo
Bavaleke imilomo kungena uKelly	Ezokungcebeleka
Isiyatholakala iToyota Fortuner ethuthukisiwe	Ezezimoto
USuthu nesibopho sokujika izinto	Ezemidlalo
Akayi ndawo noma kuphela isizini uCavin	Ezemidlalo
Masilwe nobugebengu sakhe umnotho weTheku	Imibono
Masingakuvumeli ukusetshenziswa wuSathane bakithi	Imibono
Ukuthakasele ukuba semdlalweni omusha	Ezokungcebeleka
Kuningi okudala umdlavuza webele - ungoti	Intandokazi
Limenyezelwe iqembu leBanyana	Ezemidlalo
Isikhulu sithi amaphaphu phansi ngoThongathi	Ezemidlalo
OwePirates ubhekwe ukuqeda ishobolo leminyaka	Ezemidlalo
Ifike nengqophamlando ye-warrranty iChery Tiggo 4 Pro	Ezezimoto
U-Onyango uyazixolela ngephutha elenzekile	Ezemidlalo
UComitis ubheke iTop 8 kwiCity evuzisa amagoli	Ezemidlalo
Ingwazi igxeka isenzo sabeBucs	Ezemidlalo
Baphika eyokuthungatha abalingisi abakwaFerguson	Ezokungcebeleka
OweBucs ukhuthaze ozakwabo bephunyula	Ezemidlalo
Ubona uzoba nzima umdlalo wabo neChippa uNcikazi	Ezemidlalo
Buka: AmaBMW eshaya izidudla eMsinga	Ezezimoto
Nihamba ninethezekile ngeVW Kombi	Ezezimoto
Owesibhuda ugcotshelwe ukuphatha i-Unisa	Intandokazi
Ujabulele amaphuzu wajatshuliswa nangabadlali	Ezemidlalo
Sekuphinde kwalimala omunye unozinti wePirates	Ezemidlalo
Uhulumeni ezinhlelweni zomngcwabo kaPro	Ezokungcebeleka
UHunt ufe olwembiza kufa umdlali engozini	Ezemidlalo
Sicela umnyango uphenye inkohlakalo ekulesi sikole	Imibono
U-Solinas uqinisa abalandeli idolo	Ezemidlalo
Bafuna kuhoxiswe icala kwababebhikisha kuN3	Ezokungcebeleka
IPlatinum Stars igcine idayisiwe	Ezemidlalo
Sesixhashazwe kwanele yiTheku	Imibono
UKhune kufanele azibonakalise	Ezemidlalo
Kucacile obekukhalisa uPitso ngoTau noBilliat	Ezemidlalo
Usebaqedile abaculi ebachamisa othi usebenzela uKhozi FM	Ezokungcebeleka
Kunqanyulwe inkontileka yowe-ECR	Ezokungcebeleka
IChiefs ikhiphe isinyama inqoba iCarling Cup	Ezemidlalo
UMicho ukhomba abamzondayo ngamacala okunukubeza	Ezemidlalo
ISAFA seyehlukene ngokuphelele noNtseki	Ezemidlalo
Bahlukene phakathi abalandeli beGcokama ngeDog Style	Ezokungcebeleka
IGalaxy izomangalela iPirates kwiPSL	Ezemidlalo
UMicho ufuna bafele enkundleni	Ezemidlalo
Uyingqalabutho ofundisa ukushayela	Intandokazi
Bayasolisa obaba nomama abashaya ngo-065, 060...	Ezokungcebeleka
Bathembisene umshado uKhaya noMercutio	Ezokungcebeleka
Ngeke alunge kimina u-Oosthuizen: Mchunu	Ezemidlalo
IToyota izopha abanqoba kumaParalympic Games imali	Ezezimoto
Asicatshangelwe sonke phela uma kuthathwa izinqumo	Imibono
Umpheki namathiphu ezidlo zikaKhisimusi	Intandokazi
Umlando omfishane kaMjikijelwa	Ezokungcebeleka
UHunt  akanavalo ngemidlalo esele yeligi	Ezemidlalo
Umqeqeshi uqhosha ngoJali ‘oyisiqhwaga’ se’Downs	Ezemidlalo
UMicho uzifuna zonke izicoco ezisele	Ezemidlalo
Ukhonjwe indlela umqeqeshi we-Egypt ishaywa yiBafana	Ezemidlalo
Usola uMkokstad ngokumkhiphisa isisu	Ezokungcebeleka
USiba Mtongana uzojaja ohlelweni olusha	Ezokungcebeleka
Indodana ayifuni ukuncika kakhulu kuTira	Ezokungcebeleka
UShenge ulimele iqiniso naseNdlunkulu kaZulu	Imibono
Amageza Amahle akhumbule Indidane eqopha iDVD	Ezokungcebeleka
Ubuyela kwesakhe esidala uKhenyeza	Ezemidlalo
Akucaci ngekaMasilela kwiChiefs	Ezemidlalo
Mawahlonishwe njalo amaqhawe aseSandlwana	Imibono
UBaxter akayizwa eyesicoco se-Afcon	Ezemidlalo
Makagweme okukhalwa ngakho uTshatha	Imibono
Kuvulwe ikilabhu yezintombi nto eDUT	Intandokazi
OweSundowns uchoma ’ngomshini’ wabo onguShalulile	Ezemidlalo
[IMIBONO] Bangonontandakubukwa abakhuluma eyoxolo	Ezokungcebeleka
Kudumele abaningi kushona u-Israel Mosehla	Ezokungcebeleka
UDe Sa angakujabulela ukuba yiphini likaBaxter kwiBafana	Ezemidlalo
Usenemizwa yothando lomyeni wakhe uMshoza	Ezokungcebeleka
AbaseKZN bathembisa isicoco kuma-Idols	Ezokungcebeleka
UMthembu usephupha ngendebe yomhlaba	Ezemidlalo
UMngqithi unethemba ngesimo sesitobha esimqoka kwiSundowns	Ezemidlalo
Sizihlalele hleke asinaqembu kwiBafana Bafana	Imibono
Ezothando: Asisabuzwa ubumnandi uma siya ocansini nesoka lami	Ezokungcebeleka
Ugqugquzela ukutshala ngaphandle kwamakhemikhali	Intandokazi
UDube nendawo yokujabula engenatshwala	Ezokungcebeleka
Bagxeka oshumayele  ngezitabane kunoSomizi	Ezokungcebeleka
U-Anele Mdoda usulile kwiReal Talk	Ezokungcebeleka
Uyinqobele imbokodo indondo ayithole kumaMTV EMAs	Ezokungcebeleka
Umculo kaSomnandi uyakukhulisa uhambe kahle empilweni	Imibono
Kuxabane osaziwayo kubangwa olukaBrickz	Ezokungcebeleka
U-R58 000 kowoKhozi oqavile	Ezokungcebeleka
U-Erasmus unethemba ngomdlalo wamaBhokobhoko	Ezemidlalo
IChiefs isize iPirates ishaya iWits	Ezemidlalo
Obethula i-OPW emdlalweni weTV	Ezokungcebeleka
Ifitha khaxa empilweni iHonda Fit	Ezezimoto
Kuvela imbangela yokuquleka kukaZimdollar	Ezokungcebeleka
Izwile iToyota, yashintsha iC-HR	Ezezimoto
Abuye ngezinkani amasudi kwabesifazane	Ezokungcebeleka
UTau uqale kahle eBelgium	Ezemidlalo
Siyinhlekisa selokhu kwaphatha abamnyama	Imibono
Amenyezelwa namhlanje amakhosikazi azoba sohlelweni	Ezokungcebeleka
Bafuna uMarawa abuyele emsakazweni	Ezokungcebeleka
UKapini usefana nekhubalo lokunqoba kwiGladAfrica	Ezemidlalo
Uphakele abahlala emgwaqeni usomabhizinisi waseThekwini	Intandokazi
Indodana ka-Ronaldinho ifihle uyise yaze yasayiniswa	Ezemidlalo
Umlandeli (100) waMaZulu uveza isifiso sakhe sokugcina	Ezemidlalo
UKhaya Mthethwa udalula okumholele otshwaleni	Ezokungcebeleka
Baphefumula ngokuhlehla  kohlelo lukaKhuzani	Ezokungcebeleka
Ufukula abanye abaculi uSjava ovunywa yizinto	Ezokungcebeleka
Kwenziwe izinguquko kwiToyota Hilux	Ezezimoto
Uxhaso lukaR50m konompempe	Ezemidlalo
Ulindele ingane nokuhlabana okuma-Idols	Ezokungcebeleka
Izinkinga ngomdlalo weBafana neLibya	Ezemidlalo
'Kusekuningi engisafisa ukukwenza ebholeni'	Ezemidlalo
Kumvulele iminyango ukucula ngeYadini	Ezokungcebeleka
Kugxekwa usihlalo weLeopards ngokuxoshwa komqeqeshi	Ezemidlalo
Ududuza abanezishwapha uLaSizwe	Ezokungcebeleka
'Sizolivika izembe' - owaMaZulu	Ezemidlalo
Babheke lukhulu kwiVitara Brezza abakwaSuzuki	Ezezimoto
Ukwehla kwentela kudalwa yinzuzo eyehlile yezinkampani	Imibono
UHunt unqabe ukuphumela obala ngenkinga yeChiefs idliwa	Ezemidlalo
Indida kunyamalala uZondo kuKhozi	Ezokungcebeleka
Bavume amaholoamancane behlela kuNFD	Ezemidlalo
OwoSuthu uchaza ngokweseka uKhoza	Ezemidlalo
Kuvele elikaMashaba ohlwini lwabagaqele ukuhola iSAFA	Ezemidlalo
Idinga usizo intsha yaseThekwini eyomela izwe e-United Kingdom	Ezokungcebeleka
Indoda eqotho ayimbulali umuntu ethandana naye nezingane zayo	Imibono
I-Eskom ibulala umsakazo	Ezokungcebeleka
OweBay akazimisele ngokudedela abadlali	Ezemidlalo
Bayaveva kuvalwa ukugqebheza kwiMbewu	Ezokungcebeleka
IBucs iyiphenye izinqe iChiefs kwiCarling Cup	Ezemidlalo
Kushiye isilomo somsakazi oKhozini	Ezokungcebeleka
Izimpawu ezithembisayo kuVilla	Ezemidlalo
Kwamvulela uMnyango wemali ukuqoqa udoti	Intandokazi
Kusabanjwe umoya kwiSundowns eziphuzele itiye kwi-Arrows	Ezemidlalo
Inonele ngaphakathi iMerc GLB	Ezezimoto
Kubhede wangaba nesikhathi sezintatheli	Ezemidlalo
Isiteshi sithungatha abethuli abasha bohlelo	Ezokungcebeleka
Uvuselele izifungo owazishada	Ezokungcebeleka
Uhulumeni wethu angaze avumele utshwala pho?	Imibono
Iminjunju ngeBafana koweTSG ezobhekana noSuthu	Ezemidlalo
OwamaBhokobhoko uchazwe yibhentshi  bejikela amaLions	Ezemidlalo
Ithuba lokuya eSpain kogile izimanga kwiHollywoodbets U/15	Ezemidlalo
Isifikile iLand Rover Defender	Ezezimoto
Kuvela imbangela yokumiswa kukaDikgacoi emsebenzini	Ezemidlalo
Uzolapha ngengoma abahlaselwe yizifo zengqondo	Ezokungcebeleka
IBafana izoyifica ixhugela iZimbabwe	Ezemidlalo
Umenywe kuKhozi FM umsunguli weLadies House	Ezokungcebeleka
AbePeugeot baphaka impi ngeLandtrek	Ezezimoto
Abaphethe uPitso bavivela ukubonana neSundowns enkantolo	Ezemidlalo
UKolisi uveza isizathu esenze wajoyina iSharks	Ezemidlalo
UTshatha bekumele anikwe ithuba lokukhuluma ngoBhodloza	Imibono
Owadivosa esemncane uvule inhlangano esiza abesimame	Intandokazi
Uvuna izithelo zokubekezela uLloyiso	Ezokungcebeleka
UJabu Hlongwane utinyele amakholwa	Ezokungcebeleka
Izinguquko kwelamaBhobhoko elizobhekana neWales	Ezemidlalo
Unolimi olunesankahlu uCele kepha uhlulwa umsebenzi	Imibono
I-Joyous Celebration ihoxile kumaMetro FM Music Awards	Ezokungcebeleka
'Kusikile kimina, ngavele ngakhala'	Ezemidlalo
AbeSwallows bazolulekwa ngokomqondo ngemuva kokwehlulwa	Ezemidlalo
Ubizelwe kule nto uLady D Wabantu	Ezokungcebeleka
Imenyezeliwe intengo yeGolf 8 GTI	Ezezimoto
UMasilela unqaba ukusuka eGauteng	Ezemidlalo
Abahlaziyi kabanaluvalo ngeqoqo leBafana Bafana	Ezemidlalo
AbeSharks abalizwanga ikhefu bemincile	Ezemidlalo
USkhosana ufuna uWayde abuyise amangwevu	Ezemidlalo
Intandokazi yeThe Queen isibuyile	Ezokungcebeleka
UThompson ubelwela imfundo yengane emnyama	Imibono
I-Audi A6 ikunikeza isithunzi	Ezezimoto
Kungase kucacise amagoli kumbango we-Absa Premiership	Ezemidlalo
Kuvaliwe ukulingisa kwamaphoyisa emidlalweni	Ezokungcebeleka
Agwemene amaqembu aseKZN kwiNedbank Cup	Ezemidlalo
Usuzothanyelwa bukhoma owamaCrown	Ezokungcebeleka
UBlack Coffee uyobangena ngengoma eSpain	Ezokungcebeleka
UBaxter uchaza ngokubiza oweChiefs	Ezemidlalo
Uvalwe isigubhukane umsakazo iNCR	Ezokungcebeleka
Ufuna ukukhula ekulingiseni oweThe Herd	Ezokungcebeleka
Umndeni kaMabhida uzotheleka kokaKhuzani	Ezokungcebeleka
'USteve udinga iphini elinamava'	Ezemidlalo
Intaba yaseDubai ithakasela ushintsho empilweni	Ezokungcebeleka
UBenni ugxeka abadlali abazenza izinsephe	Ezemidlalo
Uzoqashwa wonogada ubusuku nemini uJub Jub	Ezokungcebeleka
Isinqumo sokusebenzisa iVAR kweye-Afcon	Ezemidlalo
Usihlalo ukhala ngezinkinga ezibambezela izinhlelo zeqembu	Ezemidlalo
Bekushaya umoya kwiChiefs nakwiPirates kusayinwa abadlali	Ezemidlalo
IBucs ilahle ithuba lokuqhwakela	Ezemidlalo
Lukhuza ibuya uhlelo lwezimoto kwi-1KZN TV	Ezezimoto
Umlingisi woZalo ungene emculweni ngokukhipha ingoma yegqom'	Ezokungcebeleka
Ufuna abesifazane bavelele owamafilimu	Ezokungcebeleka
I-Audi yethule izimoto ezintsha ezingu-15	Ezezimoto
UStuart Baxter usememezele abazodlalela iBafana kwi-Afcon	Ezemidlalo
Umqeqeshi umbona eseyilungele iBafana               owe-Arrows	Ezemidlalo
Zicazelana R1m izintokazi kwiligi yeSafa	Ezemidlalo
Kudlisa uKabza De Small noSun-EL kumaSAMA	Ezokungcebeleka
IRoya AM nesinyathelo ngombango ngesicoco seGladAfrica	Ezemidlalo
Izingane akuzona izikhali zempi yabazali bazo	Imibono
UKatsande uvalelisa kusihlalo nabalandeli baMakhosi	Ezemidlalo
Bashaye udaka abaphathi boKhozi	Imibono
'Kunyomfeka izinhlelo ngenxa yeCovid-19'	Ezemidlalo
Usazoqhubeka nokushintsha abadlali uSolinas	Ezemidlalo
Uzobahlekisa phesheya kwezilwandle	Ezokungcebeleka
Ayicutshungulwe eyelobolo elimba eqolo singekho isidingo	Imibono
Akuveze obala amazwe asentshonalanga ukubukela phansi i-Afrika	Imibono
UPitso ufuna siqine isifociya kubadlali	Ezemidlalo
Liphezulu izinga leCitroën C3	Ezezimoto
IBanyana iwubheke ngabomvu owobungani neSweden	Ezemidlalo
IKia yethule isedan entsha iPegas	Ezezimoto
UMajavu useqalile ukukhuculula uhide lwamacala kwiPSL	Ezemidlalo
Izinhlelo zikaKhuzani ngeMabhida	Ezokungcebeleka
Ingwazi ihlaba abagxeka uBobby ngezinkinga zeChiefs	Ezemidlalo
Onompempe bavaleleke ekuhambeni ngenxa yeCovid-19	Ezemidlalo
AmaBoks nesimo esibucayi koweWallabies	Ezemidlalo
Akasafuni nokuyibona eyokuvika izembe oweMaritzburg	Ezemidlalo
Akusizi ukuxosha abaqeqeshi eKZN	Ezemidlalo
UNtencane ufuna uR1 million konina bezingane zakhe	Ezokungcebeleka
UKomphela usebheke noma yini kwiChiefs	Ezemidlalo
Ingcosana yamathikithi kwi-Extravaganza	Ezokungcebeleka
Umgulukudu endlini kaRihanna	Ezokungcebeleka
'UNtshangase ukulungele ukudlala kwiBafana'	Ezemidlalo
UMshoza uzobe esinda phansi ekotiza emakhaya ngelizayo	Ezokungcebeleka
OweBafana ufisa ukushiya iSuperSport nendebe	Ezemidlalo
Kunyukile ukuthengwa kwezimoto ngo-2021	Ezezimoto
Kwenzeke obekuphikwa uMicho	Ezemidlalo
UKatsande uchitha eyabacela imali ngegama lakhe	Ezemidlalo
AbeBucs bafuna ukugubha engu-80 ngesicoco seNedbank	Ezemidlalo
Kulindeleke iChiefs icacise ngabadlali abaziqeqesha nayo	Ezemidlalo
Kuhoxe iGcokama kwekaNova	Ezokungcebeleka
Akazimisele ngokuzinza emculweni uMshunqisi	Ezokungcebeleka
POTSHOZA: Imibuzo ngekusasa likaMcCarthy Kwi-City	Ezemidlalo
USello Maake KaNcube noTina Jaxa ngabavelele emdlalweni omusha iVula Vala	Ezokungcebeleka
UKolisi usebheke kwiCell C Sharks	Ezemidlalo
Cubungula izinto ukuze ungadlali abelaphi mbumbulu	Imibono
Umqeqeshi usabhala ecisha ngomqhudelwano	Ezemidlalo
UMbuzeni 'uziqhathe' nengoduso ngesithombe egone uGlama kaMaskandi	Ezokungcebeleka
Ithuba loMzansi lonozinti abasebancane	Ezemidlalo
Inkulumo kaMakhosi iyaxova	Imibono
UNgizwe ufuna kukhishwe uZuma ezinsukwini ezintathu	Ezokungcebeleka
Alikho icala lokudlwengula elavulelwa uKhuzani: amaphoyisa	Ezokungcebeleka
AbeMetro bajabule bephatha kumaSafta	Ezokungcebeleka
IRoyal AM iphinde yanyomfa izinhlelo zePSL	Ezemidlalo
Sihlalele ethembeni ngoPhiri: Larsen	Ezemidlalo
Ukusha kwePhalamende akulona ishwa, kuyihlazo	Imibono
UNomvethe uthipha uLorch kweyePSL	Ezemidlalo
Bakhala ngokungaholelwa abalingisi abengeziwe boZalo	Ezokungcebeleka
Udlala ngabantu uMnyango wezokuThutha eKZN	Imibono
UTeko ohlelweni lokufukula intsha	Ezokungcebeleka
IBafana izodlala eFNB Stadium	Ezemidlalo
Umsakazi we-ECR ufuna okukhulu	Ezokungcebeleka
Owo	Ezokungcebeleka
Liyandlondlobala ibhizinisi lothungela abondlekile	Intandokazi
ICape Town City ayikaqedi ukusayinisa abadlali: Comitis	Ezemidlalo
Uzigqaja ngohla olugweme ukungqubuzana kweyePSL neyeCAF	Ezemidlalo
Zizobuya ngonyaka ozayo izilomo zePirates ezilimele	Ezemidlalo
OweDistruction Boyz ukhiphe ingoma	Ezokungcebeleka
Basiza izingane eziduve ezibhedlela	Intandokazi
USono ugwema inkulumo yokudla isicoco seligi	Ezemidlalo
UKhuzani nephupho lokudumisa umaskandi	Ezokungcebeleka
Senyukile isibalo sokuthengwa kwezimoto	Ezezimoto
Sebebanga ukukhokhelwa kukagesi endlini uBlack Coffee no-Enhle	Ezokungcebeleka
UMshunqisi nethemba lendondo kumaSama	Ezokungcebeleka
UZikalala uhalalisele uKhuzani	Ezokungcebeleka
UMobara nethemba lokunqoba isicoco seligi	Ezemidlalo
UKhune, Serero noZungu babuyele kwiBafana	Ezemidlalo
Elakuleli livule ngegolide kumaWorld Champs	Ezemidlalo
UBabes usekulungele ukushada noMpintsho	Ezokungcebeleka
Sikhona ukumsiza uRicardo Goss: Onyango	Ezemidlalo
Kubalulekile ukuthatha umshwalense ozovikela ibhizinisi	Ezezimoto
Kuyamjabulisa ukuhlonishwa ngegalelo lakhe emculweni wesintu	Ezokungcebeleka
OweSwallows uncoma amagalelo omakadebona	Ezemidlalo
Utusa ubukhulu bukaNkulunkulu ngeFillUpFNB	Ezokungcebeleka
ULerato Kganyago uhlaba ikhefu kwezokudijeya	Ezokungcebeleka
UKomphela akaneme  ngephuzu	Ezemidlalo
U-DJ Ganyani uzokhipha i-albhamu ka-10	Ezokungcebeleka
UMdantsane usifuna eKapa isicoco seMTN8	Ezemidlalo
Ithathwaphi imali yokungcwaba osopolitiki nosaziwayo?	Imibono
Uzalo luxabanise abazalwane ngemali	Ezokungcebeleka
[IMIBONO] Mayinqandwe eyenkolo ohlelweni lukaTshatha	Ezokungcebeleka
OwoKhozi usakazwe ngezimpama ngenxa yentombi	Ezokungcebeleka
U-Itu Khune uselahle ithemba	Ezemidlalo
Uzoduduzwa yiTop 8 osakhala ngoweGalaxy	Ezemidlalo
UMosimane uphinde wagadla kuTinkler	Ezemidlalo
Kuvela okulethele uHlatshwayo ibhande efika kweZimnyama	Ezemidlalo
Othandweni sekwaba semfuleni wegazi	Imibono
UBhaka usephendule umuzi wakhe indawo yobumnandi	Ezokungcebeleka
Bathengi yazini okuzonisiza ngalesi sikhathi seCoronavirus	Imibono
Ayikaziwa 'eyamakhehla' kwiChiefs	Ezemidlalo
Uhlelo oluveza impilo yobungoma	Ezokungcebeleka
Kubuya umcimbi wokuklomelisa abaculi	Ezokungcebeleka
Kungase kumphinde okumenze ngowabakhaya	Ezemidlalo
Bayambandaza oTinkler noBaxter ngezifiso zabo	Ezemidlalo
'Kunqabe umusa' uThinah Zungu esinda engozini	Ezokungcebeleka
UMchunu ugabe ngamava empini yokuhlunga	Ezemidlalo
Ufuna ukushiya umsizilo kwezokusakaza uBongani	Ezokungcebeleka
OwoKhozi uhlukumezekile ebhala incwadi	Ezokungcebeleka
Usejoyine elivamise ukudla izicoco uMahlangu	Ezemidlalo
Ukufana ncamashi kubuye kuwaqhathe amawele	Ezokungcebeleka
Asigwemeni ukuthola izingane ezingahlelelwe	Imibono
Inkakha yeBanyana izoncelisa amawele ngeSafa	Ezemidlalo
'Akangakunaki ukugxekwa uKhune' - McCarthy	Ezemidlalo
IHonda yethule iSUV encane iWR-V	Ezezimoto
Ngicela uNomzamo ethule ezezitimela ehlelekile	Imibono
Ubhoboka ngolweMabala Noise uRiky Rick	Ezokungcebeleka
Isitobha seChiefs nesifiso sokunqoba imidlalo esele	Ezemidlalo
Akazenyezi ngazalwe eyikhona uMiss Sundowns	Intandokazi
Kuminciwe oKhozini ngezinguquko ezizayo	Ezokungcebeleka
UTeko Modise uzohlaziya imidlalo ye-Afcon	Ezemidlalo
USelbeyonce uyotetemuka kumaBET	Ezokungcebeleka
UBaxter uchitha eyokuthintwa yizikhulu zeSafa ngetoho	Ezemidlalo
ISascoc ayinandaba nezinsongo zesikhulu	Ezemidlalo
UZakwe ubonge abazali ngempumelelo yakhe	Ezokungcebeleka
Usola ukuntuleka kwamava beshawa	Ezemidlalo
Bakhathazekile ngoMshoza osesimeni sempilo 'esingesihle'	Ezokungcebeleka
Uzobambula izinqe aboKhozi uLinda Sibiya	Ezokungcebeleka
U-Boucher uncome ubuhlakani kumaProteas	Ezemidlalo
UKhuzani nohlelo lwethelevishini olukhuluma ngaye	Ezokungcebeleka
Bayaphawula abaqopha umdlalo i	Ezokungcebeleka
'Abadlali beChiefs ababhukule'	Ezemidlalo
IBaroka neBidvest bathembisa oshisayo koweTelkom	Ezemidlalo
Inkulu ingcindezi kwabesifazane abafuna izinqa	Intandokazi
Wesaba ukuguga nokuqhubeka nemfundo uLaSizwe	Ezokungcebeleka
Luyinkinga uthando olwakhiwe ngomuthi	Imibono
Umuntu akafake isifonyo noma ahlale ekhaya	Imibono
Abakuleli efilimini yaseHollywood	Ezokungcebeleka
'Sisebenzela ukubuyela esicongweni'	Ezemidlalo
Abafowabo bakaVeronica Phewa beza kahle ebholeni	Ezemidlalo
Kuyisibusiso ukuba ngonsundu, masizamukele siphile ubuthina	Imibono
Luya kuMzansi Magic olukaBabes noMampintsha	Ezokungcebeleka
IBucs inciphise igebe ngokushaya iChippa	Ezemidlalo
UMhlathuze uzoxhasa iThanda Royal ngo-R3m	Ezemidlalo
IMan United ibheke ukuvuka ngowomkhaya	Ezemidlalo
U-Ellis udalula ikhubalo leBanyana Banyana yezimanga	Ezemidlalo
Bahlonishwe ngeziqu zobudokotela osaziwayo	Intandokazi
UBroos ufuna ukubona iBafana elwayo koweGhana	Ezemidlalo
USokhela akazisoli ngaphawula ngakho	Ezemidlalo
Uzocacisa umdlalo wakusasa wamaBoks	Ezemidlalo
Akungethusi ukubuya kweSwallows: Biyela	Ezemidlalo
[IMIBONO] Ngiyamvuma uQhosha ngomculo wakhe	Ezokungcebeleka
Ngeke sifake ingcindezi kubadlali: Micho	Ezemidlalo
Wumsebenzi kabani kanti ukubala imali etekisini?	Imibono
Ucaphune ibhayibheli echaza ngokufuna ukuba umakhwapheni uSkolopad	Ezokungcebeleka
Ukhala ngobandlululo kwiHockey	Ezemidlalo
OweDA ukhala ngoKhozi FM kolwengoma yonyaka	Ezokungcebeleka
Imenenja iqinisekise ifindo likaParker neChiefs	Ezemidlalo
ULarsen ubalisa ngomdlali ozohamba	Ezemidlalo
ISundowns Ladies ibheke eGibhithe	Ezemidlalo
Kuvuka isiphithiphithi kolweRoyal AM neSekhukhune	Ezemidlalo
‘Bazozethemba kakhulu abadlali’	Ezemidlalo
AmaProteas azimisele ukunyathela ngolusha eWest Indies	Ezemidlalo
IFord ikhiphe iservice plan ezimotweni zayo	Ezezimoto
[IMIBONO] OwePirates usho okungafanele ngeChiefs	Ezemidlalo
Usayine iminyaka emine kwiBrighton uTau	Ezemidlalo
Asedayise aphela amathiki kaR5 000 lilinye okudla noMseleku	Ezokungcebeleka
Iyangqasha emgwaqweni iHyundai i30 N	Ezezimoto
Usephatha izinhlelo nosaziwayo u-Ibanathi	Ezokungcebeleka
Abesitebele somculo wokholo bazobonakala kwifilimu yokuthwala	Ezokungcebeleka
ISuperSport ihlose ukukhiphela isibhongo kwiSundowns	Ezemidlalo
Uvaleliswe ngomdanso uKiller Kau	Ezokungcebeleka
Kuyibhedele iRoyal AM ichithwa inkantolo	Ezemidlalo
Udonsa kanzima owengoma ethi Eyadini	Ezokungcebeleka
Kubanjwa zidindi ziphunyuka kwiChiefs kweyeligi	Ezemidlalo
Athwele kanzima amaphoyisa bakwethu	Imibono
[EZOTHANDO] Umyeni wami usefuna ukuthatha unkosikazi wesibili	Intandokazi
Uzolingisa indawo yesigelekeqe  kwiSibaya	Ezokungcebeleka
I-DA ngeke ibe yikhambi lokuxazulula izinkinga zabamnyama	Imibono
UParker uzozanyelwa esokuqeqesha kwiChiefs	Ezemidlalo
Ibe nesasasa ifika ingoma yeKings of the Weekend	Ezokungcebeleka
UMahlambi angase abolekwe AmaZulu	Ezemidlalo
I-Arrows ibuyele kwamhlaba ihlulwa elisemsileni	Ezemidlalo
Kujabule imenenja yomdlali weChiefs ngoBaxter	Ezemidlalo
IGalaxy inciphise amathuba ePirates okungena kweyeCaf	Ezemidlalo
Usuzokhonjiswa ku-SABC oweBafana neLibya	Ezemidlalo
UJele usazimisele ukwenza lukhulu kwiPirates	Ezemidlalo
Usephinde wakususa futhi lokho uRasta edweba uHHP	Ezokungcebeleka
Kuphazamisile ukugula kukaMjikijelwa	Ezokungcebeleka
Waqala engunogada odidiyela umculo kwiVibe FM	Ezokungcebeleka
Ngeke isishaye iChiefs: owoSuthu	Ezemidlalo
U-Boucher usazophawula ngezinsolo zokucwasa	Ezemidlalo
Ibingabaliwe iBanyana oxhasweni lweSafa	Ezemidlalo
Ukhathazwa ukuvuza kwamapali owaMaZulu	Ezemidlalo
UZahara ubopha iTS ngokudla amandla akhe	Ezokungcebeleka
ISharks iphunyuke sekukubi kwiGriquas kwiCurrie Cup	Ezemidlalo
Sebeqalile ukubheka izindawo abazozivakashela	Ezokungcebeleka
Ikugeza inhliziyo iToyota Urban Cruiser	Ezezimoto
Ayaphela amathikithi omcimbi weNtandokazi	Ezokungcebeleka
Sasithi silungcwabile ubandlululo	Imibono
IPirates ifuna ukuhlaba ikhefu ngegiya eliphezulu	Ezemidlalo
Umelwe yinhliziyo owaduma kumaBoks	Ezemidlalo
UKomphela uchazekile ngensephe enguParker	Ezemidlalo
UThuso Mbedu uhlabane ngendondo ephambili eHollywood	Ezokungcebeleka
Akeneme ngesimo seqembu unozinti weSundowns	Ezemidlalo
Uqine idolo oweBucs kubuya izethenjwa	Ezemidlalo
Kuvuleke amasango iPirates ibhudluza iStellenbosch	Ezemidlalo
Ugonyuluka ngokufa komyeni encwadini entsha	Intandokazi
Izowumela umbango iKia Sonet	Ezezimoto
Kukhonye AmaZulu eba ngompetha beDiski	Ezemidlalo
UBroos utusa ubuqhawe kwabeBafana	Ezemidlalo
Ithuba lokugcina lamathikithi e#GcwalisaiMabhida	Ezokungcebeleka
Ngihlaba ukuhlukunyezwa kwabesifazane	Imibono
Usencelisa amawele oweThe Queen	Ezokungcebeleka
Abantu kumele bafundiseke ngengozi yotshwala	Imibono
IBarcelona noMessi nengcindezi kwiLa Liga	Ezemidlalo
Amakhosi agqemeke udume ngaphambi kowomkhaya baseSoweto	Ezemidlalo
Izonyukela kwelinye izinga iMpucuzeko	Ezokungcebeleka
Kuningi abantu abangakuzuza kwiQuran	Imibono
‘Ngikhululekile ngokuhoxiswa kwecala’	Ezemidlalo
Inkulu kunendala iMercedes-Benz C-Class entsha	Ezezimoto
Isivikele isicoco sama-Idols iKapa	Ezokungcebeleka
Ziqokwa ngoLwesibili izintokazi eziku-Top 10 kaMiss SA	Intandokazi
Kuhlanganiswa ifilimu ngoMandoza	Ezokungcebeleka
IRoyal AM ithole uxhaso lwezigidi kuMasipala weTheku	Ezemidlalo
UMahlasela angase adlale ngesizini ezayo	Ezemidlalo
Kuzokwethulwa olunye uhlobo lweFord Ranger	Ezezimoto
Uhoxisiwe umdlalo wePirates weCaf	Ezemidlalo
Uzimisele ukuyivusa iKZN Music House	Ezokungcebeleka
URasta usehloniphe uTatjana ngadume ngazo	Ezokungcebeleka
UMchunu uthipha indodana kweyebhande lomhlaba	Ezemidlalo
Izibusiso zikaMotaung kuKhuzwayo esefulathela iKaizer	Ezemidlalo
Qaphela ungangeni enkingeni	Ezezimoto
‘UBenni akakulungele ukuqeqesha iBafana’	Ezemidlalo
Ligqashukile igoda kuKelly Khumalo noChad	Ezokungcebeleka
UMdonso usebuyele kuKhozi FM	Ezokungcebeleka
Osaziwayo banikele kwabaswele ngePhasika	Ezokungcebeleka
Sifuna ukwaziswa ngezinguquko kubasakazi: aboKhozi	Ezokungcebeleka
Uqophe umlando udokotela owakhula elusa	Intandokazi
UChris ungene ngephutha ekulingiseni	Ezokungcebeleka
Kuxwayiswa abashayela bengalifasile ibhande	Ezezimoto
OweBucs ucacisa ngokumxoshe eMphithi	Ezemidlalo
Liphezulu izinga leRanger XL Sport futhi iphephile	Ezezimoto
I-BET Africa iza nohlelo oluzosiza abafuna omaqondana	Ezokungcebeleka
UFish uchazwe uMkhize kwi-Afcon	Ezemidlalo
UJele ukhuthaza abadlali ngomdlalo neSundowns	Ezemidlalo
UMngqithi ubonga ukubuya namaphuzu koweSuperSport	Ezemidlalo
Uqweqwe olungu-Igesund lukhonjwa kwiTTM	Ezemidlalo
EZOTHANDO: Ngizoshada nobaba wengane kodwa sengikhulelwe eyomunye	Ezokungcebeleka
IBaroka inyomfe umcimbi weChippa koweligi	Ezemidlalo
Usemanzini uPsyfo oshonelwe unina	Ezokungcebeleka
IPirates nenselelo yokubuyisa izinduku kwiSundowns	Ezemidlalo
‘Angikhulumi ngenzuzo yami ebholeni’	Ezemidlalo
USithebe wemukela inselelo yejezi	Ezemidlalo
Khethisisa izifundo zakho ngokwamathuba omsebenzi	Imibono
'Manje ngeke ngisakwazi ukubamba isandla somngani wami?' - Khuzwayo	Ezokungcebeleka
Kuzophela izinyanga  engabonwa	Ezemidlalo
Ukhulelwe eyesibili unkosikazi kaCaster	Ezokungcebeleka
UTinkler ubheke amabhonasi kwiMaritzburg	Ezemidlalo
Ungazisusa kanjani izinsumpa ezimiliswa wukukhula esikhumbeni	Ezokungcebeleka
IChippa isivale ngomdlali isikhala sikaHunt omisiwe	Ezemidlalo
Usosayensi waseKZN enkundleni noNaomi Campbell	Intandokazi
Kusizakala nentsha ngebhizinisi lakhe lokuthunga	Intandokazi
Babuyelene uBabes nomuntu wakhe	Ezokungcebeleka
USukazi ucacisa ngokuxosha umqeqeshi	Ezemidlalo
Banqwahe nemali yethu eCoastal College	Imibono
UDe Sa ufuna ukubamba umgqigqo kaDavids kuMaritzburg	Ezemidlalo
IDowns iqongise izinkinga zeWits	Ezemidlalo
Umkhiqizi wewayini ufuna ukufukula abamnyama	Intandokazi
Amakhansela anonya uma ekhipha ukudla	Imibono
Ngiyifanisa nenganekwane inkulumo kaMotshekga	Imibono
Kuzocacisa izitobha ngomklomelo wamagoli	Ezemidlalo
Iyashuba eyamazwi kuKaybee noCassper	Ezokungcebeleka
OwoSuthu ubabaza ukuzinikela kwabadlali	Ezemidlalo
Kushode ozogadla kuChicco no-Arthur	Ezokungcebeleka
Sebeqokiwe abazomela iBanyana	Ezemidlalo
IBafana izethule umthwalo ishaya iSao Tome & Principe	Ezemidlalo
Ngabe iSaru ikhathele ukuhlaliswa lubhojozi?	Imibono
UJakarumba usayibambile emculweni waleli zwekazi	Ezokungcebeleka
'Makuboshwe abenzi bobubi'	Ezemidlalo
Zibukele abantu bakuleli bewaphendula ihlaya ama-video kaMampintsha noBabes Wodumo	Ezokungcebeleka
Uyazikhandla ukuze kuhlomule isizwe	Intandokazi
UL'vovo kwabakhululwe yiMabala Noise	Ezokungcebeleka
Indida ngomthetho we-Aarto okumele uqale ngoJulayi 1	Ezezimoto
Linyukile izinga leMercedes-AMG CLA 45 S 4MATIC+	Ezezimoto
UMalajila uveze imfihlo ngomqeqeshi weChiefs	Ezemidlalo
Zikhona izimoto ezibiza ngaphansi kukaR50 000	Ezezimoto
Injabulo kwanda imidlalo yase-Europe	Ezemidlalo
OweBucs ulandula  eyamagqubu	Ezemidlalo
UKomphela ubalisa ngezimbangi zakhe	Ezemidlalo
Baphumela obala ngokuthandana	Ezokungcebeleka
Imenenja ilindele ukucaciselwa ngekusasa lowe-United	Ezemidlalo
Amaholidi aphazamise ukudayisa kwezimoto	Ezezimoto
Okamaskandi ufe olwambiza kushona iciko emculweni	Ezokungcebeleka
Osebenza ezingadini uyogijima e-UK	Ezemidlalo
Sicela kungenelelwe kusizakale abafundi	Imibono
UMnqobi Yazo usolwa ngokugoloza ukukhokhela imoto yentombi	Ezokungcebeleka
Osomathuba badunga isimo e-UKZN	Imibono
UNgizwe uphika eyokwedelela imigomo yeCovid-19	Ezokungcebeleka
Kuyamcika okwenziwa wonozinti bakhe	Ezemidlalo
UNomvethe unxusela uTau kubalandeli beBafana	Ezemidlalo
Ubuxoki obubulala ibhola ezifundeni zeSafa - Mkhize	Ezemidlalo
Umrepha uzame ukuzibulala ngenxa yokhwantalala	Ezokungcebeleka
Usethathwe yiThe Queen obelingisa kuZalo	Ezokungcebeleka
I-Ajax kayisiboni isono ngokulwela ebikufuna	Ezemidlalo
UMr Magic ubonge uMalema ngokulwela uZuma namaciko	Ezokungcebeleka
OweBucs uthembisa uBaxter induku	Ezemidlalo
IFiat 500 yethulwe nezinguquko	Ezezimoto
Okushaqisayo ngomgadli weBafana Bafana	Ezemidlalo
ISABC isiphuce uNgizwe esinye isinkwa	Ezokungcebeleka
UGqoboka wenza ukubalungagqobhoki udonga lweBulls	Ezemidlalo
Ngifisa kuphenywe indlela yokuqasha abasebenzi bakadoti	Imibono
Ogogo benze okuhlule iBanyana eFrance	Ezemidlalo
UGcaba ubona iCosmos isenethuba embangweni wesicoco seGladAfrica	Ezemidlalo
UKekana ubalisa ngesikimu	Ezemidlalo
UMarawa usola iSABC ngokufa kwabasakazi	Ezokungcebeleka
Kushone  owaduma kuMatshitshi Amhlophe	Ezokungcebeleka
UBaxter uyavutha ngesinqumo seSafa	Ezemidlalo
UConnie uzothi lungu-nje kuGenerations:The Legacy	Ezokungcebeleka
Singakunqoba ukushintsha kwezulu uma sibambisene	Imibono
‘Ngizobonakala emdlalweni omkhulu’	Ezokungcebeleka
UDavids uzoqeqesha i-United ngokugcwele	Ezemidlalo
Kuwubizo ukusiza abantu koyisikhulu kwiSolidarity Fund	Intandokazi
Kumnyama ngebhola kuvunyelwa eminye imidlalo	Ezemidlalo
Ukhozi FM luzosinxephezela kanjani thina balaleli balo?	Imibono
USenong omemezele isikwati ugabe ngoMahlambi ku-Under 20	Ezemidlalo
ISundowns ibuyele kwamhlaba ihlulwa	Ezemidlalo
Isifikile i-Audi A3 entsha	Ezezimoto
IMaqaqa izovalwa ngowezilomo zowokholo	Ezokungcebeleka
Unozinti weBafana iyamcika eyeBrazil	Ezemidlalo
Abangeyisayo abanezisu ezinkulu nezimbejeje - Zahara	Ezokungcebeleka
Ziphulwe izinhliziyo ezikaFaro kunqoba i-Uruguay kowoMhlaba	Ezemidlalo
Akawuvali umlomo ngethuba alitholile umlingisi oqavile kuKalushi	Ezokungcebeleka
Yenza ezibukwayo iTS Galaxy kwi-CAF	Ezemidlalo
Ube neMinenhle edlulela phambili emncintiswaneni woKhozi	Ezokungcebeleka
Kulinyazwe oweTV kwaxoshwa onogada	Ezokungcebeleka
Iqhubekile nokugqama inkinga ye-Arrows kwiDiski	Ezemidlalo
OwaMatsantsantsa uvume iphutha elibaqhathe nolaka lwe’Downs	Ezemidlalo
Liphindele emaphoyiseni elecala elavulelwa oBabes	Ezokungcebeleka
Ubuye nendondo e-US umpheki wodumo wakuleli	Ezokungcebeleka
Kubuya uhlelo oluveza osaziwayo kwiBET Africa	Ezokungcebeleka
Kuthombe okhiye kwiSundowns nePirates	Ezemidlalo
Uyashoshela ngamavoti umgadli omusha weChiefs	Ezemidlalo
Igcokama liwumele ngeqiniso umculo wakithi	Imibono
IPlus Fab nezingubo zomshado zabondlekile	Intandokazi
I-PSG isayinise unozinti waseHammarsdale	Ezemidlalo
Iyawushubisa umbango iSuzuki Vitara Brezza	Ezezimoto
I-Chippa ifuna ozovala isikhala sikaMothwa	Ezemidlalo
Bachonywe uphaphe abakhulele ezinkulisa zeSuperSport	Ezemidlalo
Bakhuza ukuqagela ngozovala esikaSomizi	Ezokungcebeleka
Umfuna kwiChippa oweBucs uLarsen	Ezemidlalo
Omunye umsindo ngekaMpintsho	Ezokungcebeleka
Uzishaya isifuba owaMaZulu besinda	Ezemidlalo
UMcCarthy nenkinga yokugqoza kwamagoli	Ezemidlalo
IChiefs ikhombise ukuba buthaka idlala ngamaphuzu	Ezemidlalo
Usabona umqansa oqhwakele	Ezemidlalo
UMngqithi udalula imfihlo yabo kwiDowns	Ezemidlalo
UKelly angase afakwe enkantolo	Ezokungcebeleka
Ngeke simsayinise uThuso Phala: Johnson	Ezemidlalo
UNomvethe ufuna ukushaya iDowns	Ezemidlalo
Iyanda ingcindezi kuBenni ophikwa yimiphumela	Ezemidlalo
Iseluleko sabeGenerations kwabafisa ukulingisa	Ezokungcebeleka
Ubengayizwa eyezolimo obaqwaqwade bonke	Intandokazi
Izimoto zakwa-Opel sezidayiswa yiPeugeot Citroen SA	Ezezimoto
UHunt akanaso isiqiniseko ngekusasa kwiWits	Ezemidlalo
[IMIBONO] Ngidumele ngehlazo likaZodwa Wabantu	Ezokungcebeleka
Uhlukile kwakulingisayo ojoyine Uzalo	Ezokungcebeleka
UBeyoncé ufeze iphupho lowegqom’	Ezokungcebeleka
U-Ayanda Ncwane usolwa yinkampani ngesikweletu	Ezokungcebeleka
UTinkler usezocija iSuperSport United	Ezemidlalo
Umgadli akuvumanga ajabulele umklomelo	Ezemidlalo
URamaphosa wenza obekwenziwa wuZuma	Imibono
Igcokama lihlukanise abalandeli baMageza	Ezokungcebeleka
Sengikhathele yizinhlamba zoMntwana uThokozani: Buthelezi	Imibono
Kuyaphoxa ukungabibikho kwabalandeli kowomkhaya: Lekoelea	Ezemidlalo
Kuzobungazwa abaqopha umlando neBafana ngo-1996	Ezemidlalo
Odume ngokusebenza nosaziwayo usekwiHouse of Zwide	Ezokungcebeleka
UMosimane weluleke uMicho	Ezemidlalo
Kulele kubagadli ekwenzeni iWorld Cup ihlabahlose	Ezemidlalo
Abaholi kabayilandeli imithetho kamengameli	Imibono
Kukhalwa ngesinyama kuMayambela	Ezemidlalo
IPirates ethubeni lama-quarterfinal koweCaf	Ezemidlalo
Umethuli wezinhlelo usezolingisa kuZalo	Ezokungcebeleka
IDistruction Boyz ivivele impi yengoma	Ezokungcebeleka
Ezothando: Abasemzini bathi ngabulala umyeni wami ngengculazi	Ezokungcebeleka
UHlengiwe uthi akalwi noBig Fish ngezigidi	Ezokungcebeleka
OKhozini umuntu bamazi ngoba eseshonile	Imibono
URantie udonswe ngendlebe ngendlela yokuziphatha	Ezemidlalo
Indida kushiya oweNo Excuse Pay Papgeld	Ezokungcebeleka
Uzidonsele amanzi ngomsele	Ezokungcebeleka
Uziduduze ngendondo azithengele yona uMalinga	Ezokungcebeleka
UBaxter uthembisa ukuzinuka amakhwapha ngehlazo leRoyal AM	Ezemidlalo
UDolly akayizwa eyokudlala e-USA	Ezemidlalo
UBroos ucikwa ngamaqembu aseMzansi amenzela phansi	Ezemidlalo
UMicho uwufanisa nowamanqamu oweCity	Ezemidlalo
Umqeqeshi weGhana ubalise ngokulimala kuka-Ofori	Ezemidlalo
Umangele beshaywa yiFree State Stars	Ezemidlalo
IDowns ivule igebe kwi-log ishaya iStellies, iBay yawasha ijezi	Ezemidlalo
OweLeopards nethemba lomklomelo wamagoli	Ezemidlalo
Unkosikaiz kaHHP ukhala ngabangafuni baqome abafelokazi	Intandokazi
Unikelele isikole ngezihlalo uKhuzani	Ezokungcebeleka
OkaCaster akanandaba nokuzitshwa yi-IAAF	Ezemidlalo
UZinnbauer ujabulela ukuqala isizini nolwazi olungcono ngebhola lakuleli	Ezemidlalo
Ingcindezi oSuthwini idlulela phambili kweye-Caf	Ezemidlalo
Kuhlongozwa eyokuvumela abagomile koweMTN 8	Ezemidlalo
AboKhozi balubulele uhlelo lwantambama	Imibono
Uzophusha umculo wakhe phesheya	Ezokungcebeleka
URami uzolingisa ephambili emdlalweni iGiyani	Ezokungcebeleka
I-BET Africa izohlekisa ababukeli ngeBlack Tax	Ezokungcebeleka
Akaneme ngokuphaselana kwabadlali	Ezemidlalo
Ubonga izeluleko zikaYeye uMokoena	Ezemidlalo
Lugobile uphondo kuMampintsha emuva kokunqwaha noR20 000	Ezokungcebeleka
Umdlali we-Arrows ukhonjwa kwiHighlands	Ezemidlalo
UTrevor ubonge abalandeli eqokwa kuma-Emmy Awards	Ezokungcebeleka
Kugqame uRabada amaProteas ebhaxabula iBangladesh	Ezemidlalo
Angase ahlukane neDowns ngezayo uBilliat	Ezemidlalo
Badiniwe abeGagasi ngesenzo seSABC	Ezokungcebeleka
UKhuzwayo 'uphucwe' inombolo kwiPirates	Ezemidlalo
Asezoyikha ngamafosholo adlala kwi-NFD ngabaxhasi abasha	Ezemidlalo
Ukhale ngamaphutha oweSharks bedliwa yiStormers	Ezemidlalo
Akaneme ngabadlali bakuleli uKomphela	Ezemidlalo
Balandelwe ukusiza amaProteas ngesipiliyoni	Ezemidlalo
Idinga ukululekwa intombi esola uDJ ngokuyishaya	Ezokungcebeleka
Yingqovungqovu yeSUV iHyundai Palisade	Ezezimoto
UZinnbauer ufisa ukunqoba eseMTN 8	Ezemidlalo
Alikho elifune ukugoba uphondo kuSuthu nePirates	Ezemidlalo
Umangalela Ukhozi FM owalubhalela umdlalo	Ezokungcebeleka
Akhale ngaphansi  amaSharks kwiCrusaders ebizenzela	Ezemidlalo
Ubuyela eMoses Mabhida owamanqamu weMTN 8	Ezemidlalo
UMngqithi akaneme ngabebegxeka ifomu yeSundowns	Ezemidlalo
Kuhlabane abeChiefs kweyePSL	Ezemidlalo
Kuyingozi ukubekezela uthando lube seluse-ICU	Ezokungcebeleka
UBonang Matheba 'usethathiwe'	Ezokungcebeleka
AmaSharks ahlome ngeBhokobhoko kowamanqamu	Ezemidlalo
Libhekisa amabombo e-Uruguay elesizwe	Ezemidlalo
Bathi ncinci abagwedli abanikelelwe ngezinsiza	Ezemidlalo
OweStellenbosch ubambe umoya ngesinqumo sePSL	Ezemidlalo
Owayengumdlali weChiefs usola abadlali ngokuboza kweqembu	Ezemidlalo
OweTTM ufuna bagweme umlando omubi kwiPSL	Ezemidlalo
Dedani bosopolitiki endlunkulu kaZulu!	Imibono
Uyeke ubumeli eqala ibhizinisi	Intandokazi
Oku-Miss SA ukhuthaze abaningi ngomkhango wakhe	Ezokungcebeleka
Ukuwina kweBaroka kumele kuyivuse emaqandeni kwiligi	Ezemidlalo
Iyaqonga ingcindezi  kwiDowns ngeMTN 8	Ezemidlalo
Ngitusa okwenziwe wuMshengu eMenzi	Imibono
Umhlangano ophuthumayo we-PSL	Ezemidlalo
Uchitha eyokuduba umcimbi okamaskandi	Ezokungcebeleka
UKomphela uzodlala neChiefs enesilonda	Ezemidlalo
IChiefs izoxhumana nabalandeli bayo	Ezemidlalo
UMboweni uhlalelwe wumsebenzi onzima	Imibono
AmaProteas abesifazane azobuyela ensimini nge-West Indies	Ezemidlalo
Kuningi asafisa ukukuzuza oweGagasi	Ezokungcebeleka
ObekwiSibaya nefilimu entsha kaShaka	Ezokungcebeleka
Ngibonga abaholi bomphakathi KwaZulu-Natal	Imibono
UZahara usethole inkampani entsha	Ezokungcebeleka
Sizosiza ngani isikhundla se-AU kuRamaphosa?	Imibono
Izinto zenzeka ngendlela ebesifisa ngayo: Bilankulu	Ezemidlalo
Kunabadlali beDikwena abazodilizwa noJohnson	Ezemidlalo
UMohale uthi nakanjani uyamshiya uSomizi	Ezokungcebeleka
Abantu abangiqondi kahle: Eymael	Ezemidlalo
Uchichima injabulo esayiniswa inkampani yase-USA	Ezokungcebeleka
‘Bangibiza ngekhehlango-2012’	Ezemidlalo
Ubuthe izindondo ezingu-6 kuma-Awards uCassper	Ezokungcebeleka
Ehlile amaphaphu kwabeHighlands	Ezemidlalo
Uzophathisa uPitso ngekhanda	Ezemidlalo
Ufuna bangenise abesifazane embonini yamatekisi	Intandokazi
