text	label
VOA60 Lingala 20 mai 2021	justice
Bureau d’âge etiami na Sénat kasi rapporteur adjoint ya Bureau définitif ya Thambwe Mwamba atiki mosala	politiki / politique
Tshisekedi alobeli bokoti ya mampinga ya Zambie na RDC (Vidéo)	bokengi / securite
CPI ekokata ya likambo ya Bosco Ntaganda le 8 juillet	rdc
VOA60 Lingala 9 février 2021	bokengi / securite
VOA60 Lingala 28 janvier 2021	politiki / politique
Mibu 20 wuto bitumba ya Rwanda na Ouganda na Kisangani	bokengi / securite
Tshisekedi azelami na masolo na Sassou na Oyo	politiki / politique
Mbulamatari ekangi libela ba mines mibale ya Katimituga mpo bikomi nkunda ya bato bazipamaki	bokengi / securite
Ba Léopards balaki bakosala makasi liboso ya ba Pharaons ya Egypte	rdc
Totala mpasi ya bavandi ya Goma baye bakimi na Sake	bokengi / securite
Sango ya le 4 juin 2019 na VOA Lingala	rdc
Coronavirus ezwi bakonzi baiike na mokili	bokolongono / santé / medecine
CCT ekebisi kotelemisa bato lokola parlement ezali kolekisa mobeko ya CENI mondimami na mbaso te	politiki / politique
Bayi LUCHA 10 bakangami na milulu ya kosenga ya kimya mpe kobengana MONUSCO	bokengi / securite
Police esengami kolakisa elongi ya bomoto ntango ONU efundi bozwami basi na makasi	rdc
Police ezali koluka bato baliya 260 millions $ ya ba fonctionnaires fictifs	justice
"Mwasi na mobali moko bakosambisama mpo na ko ""checkula"" ministre ya Brazzaville na Paris"	justice
DG ya autorité ya aviation civile azwi etumbu nsima na bokweisami ya ballon Google Loon	politiki / politique
Ilunga Ilunkamba apesi Tshisekedi mokanda ya botiki mosala	politiki / politique
Ne Muanda Nsemi akangami	bokengi / securite
TGI etindi Blattner kosamba na Tribunal de paix mpo asalaki nde abus de confinace	justice
Guterres apameli bobomi ya koleka bato 55 na Boga mpe Tchiabi (Ituri)	bokengi / securite
USA ebakisi $3M ya lisungi na DRC mpo na COVID19	bokolongono / santé / medecine
Trump akati mbongo USA epesamaka na OMS	bokolongono / santé / medecine
Tshisekedi, Sassou, Kagame, Lourenço na bakonzi basusu ya Afrika na bokutani ya Stochi (Russie)	rdc
VOA60 20 août 2020	bokengi / securite
Tshisekedi akutani na Jaynet Kabila na Corneille Nangaa	politiki / politique
Mukuna asengi tribunal mosusu esambisa ye na Tshibola	justice
VOA60 Lingala 26 août 2020	politiki / politique
FARDC ekebisi bilenge ya Beni mpo na kosimba minduki	rdc
Tshisekedi abeti piololo ya bobandi mosala ya laboratoire ya milona na Kalambo	rdc
VOA60 Lingala 21 août 2020	politiki / politique
Basimba minduki basalaki 53% ya mbeba mpe bayi mbulamatari 47% na mars (BCNUDH)	bokengi / securite
Parlement endimi kobakisa mikolo na état d’urgence sanitaire	politiki / politique
VOA60 Lingala 23 octobre 2020	politiki / politique
VOA60 Lingala 16 décembre 2020	politiki / politique
Egypte, Sudan na Ethiopie na masolo mpo matata ya barrage ya Nil na Kinshasa wuto le 3 kino le 5 avril	politiki / politique
VOA60 Lingala 22 février 2021	bokengi / securite
Ba Sénateurs ya Etats-Unis balobi boponi ya Sassou bokembisa bokonzi ya mabe na Congo	politiki / politique
Baye bazwaka etumbu ya mibu 20 mpo na liwa ya LD Kabila babimi boloko	justice
Commissaire ya PNC Kasongo alobi bokangami ya Gombe ezali kokoba	bokolongono / santé / medecine
VOA2X60 Lingala 31 juillet 2020	politiki / politique
"Fred Bauma (GEC): ""Etat de siège ezali te eyano ya malamu koleka mpe mikolo 30 mikokoka te"""	bokengi / securite
Likita lya kotala bolongwi bwa Mabunda na Assemblée nationale lisalami	politiki / politique
TGI etelemisi boponami ya Dieudonné Kasembo bo’ motambwisi ya FEC mpe ezongisi Yuma	justice
Eyano ya mampinga ya FARDC na bitumba ya ba ADF na Ituri	rdc
Basango ya le 12 avril 2019 na VOA Lingala	rdc
"Ba Léopards na ""Seleccion"" ya Espagne na finale ya tournoi ya Malaga"	rdc
VOA60 Lingala 1er juin 2021	politiki / politique
Etats-Unis epesaki 2,8 millions $ ya bisaleli na lopitalo motoba ya RDC	bokolongono / santé / medecine
LISPED esengi etumbu na nsima ya élimination ya ba Léopards U23	rdc
Mibu misato ya misala makasi mikatameli DG ya OVD na FONER	rdc
Katumbi akutani na Sama Lukonde mpe asengi bana mboka kosunga ye na bokambi mbulamatari	politiki / politique
Ba candidats babale ya FCC mpo ebonga ya mokambi ya Sénat	rdc
Matungulu akambi BAD na masolo na PM Ilunga mpo na kosunga mbulamatari	rdc
Balandi ya Muanda Nsemi bakitaki o’balalaba na Matadi	politiki / politique
VOA60 Lingala 21 mai 2020	bokolongono / santé / medecine
Tshisekedi abimisi Eddy Kapend na baye bakangama na liwa lya LD Kabila	justice
VOA60 Lingala 5 juin 2021	bokengi / securite
Lisakoli lya Etats-Unis lya ADF bo’ ISIS-DRC	bokengi / securite
VOA60 Lingala 8 octobre 2020	politiki / politique
Egypte, Sudan na Ethiopie bayokani te na matata mpo na barrage Renaissance na Nil	politiki / politique
CPI etiki etumbu ya mibu 30 ya boloko mpo na Ntaganda	justice
Bato batamboli mpo na kotelemela maloba ma Kagame na Bukavu	politiki / politique
Ministre wa Yambo ya kala N’Singa Udjuu awei	politiki / politique
Bolukiluki bozali kosalama na misolo Access Bank epesaki na basali ya APLC (Direcab a.i. ya Tshisekedi)	justice
SG Adjoint ya ONU asololi na Fayulu, Muzito na bayi FCC	politiki / politique
Chambre du commerce ezali kosala nzela mpo na boyei ya ba investisseurs américains	rdc
Joâo Lourenço azwi bokambi ya CIRGL na kolanda Sassou	politiki / politique
Ba FARDC bakangi ba ADF banei mpe balakisi minduki 130	rdc
Fayulu na Dymanique basengi Tshisekedi na Kabila bayambola	rdc
VOA60 Lingala 20 juillet 2020	politiki / politique
Elenge ya mibu libwa azwamaki na Ebola akufi na Uganda	rdc
Litatoli ya migrante moko ndenge akomaki na USA na nzela ya makolo (1e partie)	rdc
Ba Américains bazali kopona mokonzi ya mboka na bango [TOTALA]	politiki / politique
Nzoto etano esusu ezwami na parc ya Virunga nsima na bobomami ya ba ADF	rdc
Ba Congolais balakisi nkanda na Washingon mpo bobomami ya bandeko ba bango na monyele ya mboka	bokengi / securite
VOA60 11 novembre 2020	politiki / politique
Conseil ya sécurité epaleli bobomi ya ba civils mpe botelemeli Monusco	rdc
Tshisekedi, Thambwe, Mabunda na Ilunga basololi mpo na likambo ya Congrès	politiki / politique
Matanga ya mokolo moko mpo na likama na Lac Kivu na Kalehe	rdc
Koleka bato 46 bakufi na likama na mines na Kolwezi	rdc
Bokutani ya Sassou na Tshisekedi na Sotchi	rdc
SADC epesi Zambie mikolo sambo mpo na kolongwa na mabele ya RDC (mbulamatari)	bokengi / securite
Ba magistrats batelemisi misala	rdc
Isabel Dos Santos apemeli mbulatari na kokanga biloko bya ye na lokuta	justice
Police epanzaki balandi ba Kamerhe na Kinshasa	politiki / politique
Mpepo ekweyaki pene na Bukavu emonani na parc Kahuzi Biega (Gouv. Kasi)	bokengi / securite
VOA60 Lingala 1er mars 2021	politiki / politique
Bato babale bazuwami na Ebola na Mwenga, elobi bakonzi	rdc
Sango ya le 16 août 2019 na 16h TU na VOA Lingala	rdc
Kabila na matanga ya Mgr Tafunga na Lubumbashi	politiki / politique
Norbert Basengezi alobi mpo na nini atiki mosala	rdc
Litatoli lya moto azwaki nzoto ya ntoma Attanasio na Kibumba [TOTALA]	bokengi / securite
Motango ya bawei momati na 21 nsima na bokweyi ya mabile na Maniema	rdc
Bayi bokengi babuki bureau ya président ya Cour constitutionnelle	justice
UNC esengi Tshisekedi kozongisa misala mya bosembo na nzela	justice
Félix Tshisekedi na Lubumbashi	rdc
VOA60 Lingala 19 décembre 2020	politiki / politique
MONUSCO etindiki batomboki na Ituri	rdc
VOA60 Lingala 6 novembre 2020	politiki / politique
VOA60 Lingala 22 mai 2020	bokengi / securite
V-Min. ya Santé alimboli cadre RDC na bikolo nzinganzinga basali mpo na kobundisa Ebola	rdc
Assemblée nationale etie le 12 juin mpo na kopona moto akozwa esika ya Kabund ya 1er V-P	politiki / politique
DG ya Office des routes asimbami, ya FPI ayanoli na parquet	rdc
VOA60 Lingala 03 février 2021	politiki / politique
Sarkozy akatelami mibu misato ya boloko mpo na kaniaka na misolo mya Libye	justice
Nzoto ya nkondo Tshisekedi kala te na Kinshasa	rdc
Ba ADF bafundami na koboma lisusu bato 25 na Beni	bokengi / securite
Minganga balakisi denge nini kobatela minu malamu	bokolongono / santé / medecine
VOA60 Lingala 7août 2020	justice
Tshiskedi atie mikolo misato ya matanga mpo Magufuli na RDC wuto mardi	politiki / politique
Maire ya kala ya Brazzaville akatelami mibu 5 ya boloko mpo na kopengwisa misolo	justice
Ba victimes ya monyokoli baboyi nommination ya moko ya bakambi ya ANR pene na Tshisekedi	rdc
Bokangami na ndako bokozala lisusu te na Kinshasa	bokolongono / santé / medecine
CACH na FCC bayokani mpo na gouvernement ya bato 65	rdc
FCC elobi ekopesa maboko te na makambo makoki kozongisa maponami nsima	politiki / politique
Tshisekedi asololi na Guterres mpo na matata ya barrage ya Renaissance	politiki / politique
CLC esengi Tshisekedi kokweyisa Ass. Nationale mpe kobengisi dialogue	rdc
Bolukiluki bofungwami nsima na bobomi bwa Chinois moko na cimenterie ya Lualaba	bokengi / securite
VOA60 Lingala 20 février 2021	bokolongono / santé / medecine
Baketeli Koffi Olomide mibu mibale ya boloko na France	rdc
Bandunndu bakomi kokufa mingi na bozingi lisalisi na Lubumbashi	bokolongono / santé / medecine
Mukwege asengi tribunal pénal mpo na RDC	justice
TGI/Gombe ezongisi AFDC na Bahati	politiki / politique
Fayulu asengi bato kotambola le 17 janvier mpo na kotelemela balkanisation	rdc
"Tshisekedi atie Bahati Lukwebo bo’ ""informateur"""	politiki / politique
UDPS na nzela samedi mpo na kopesa maboko na ba consulltations mpe FCC mpo na kotelemela yango	politiki / politique
Tshisekedi atelemeli trafic illicite ya mibnduki na 33e Sommet ya UA (Vidéo)	rdc
VOA60 13 novembre 2020	politiki / politique
Consultations : Olenghankoy asengi Tshisekedi kosolola na Kabila kaka bango babale [TOTALA]	politiki / politique
VOA60 Lingala 19 novembre 2020	bokolongono / santé / medecine
Nani abimisaka molongi ya maponami ma mokonzi ya mboka na USA ?	politiki / politique
Kokoma Mokonzi aponami na USA elingi koloba nini (TANGA)	politiki / politique
Mbulamatari ya RDC epusi bobandi ya bopesi mangwele ma COVID-19	bokolongono / santé / medecine
Ali Bongo atikeli Sassou bokambi bwa CEEAC	politiki / politique
Tshisekedi alobi 2021 epesi RDC libaku ya kokamba UA mpe kokende liboso	politiki / politique
Masolo ya Zambie na RDC makatami mpe makozongela le 1er	bokengi / securite
RDC ezali candidate ya komeka mangwele ya COVID-19 (Dr. Muyembe)	bokolongono / santé / medecine
FMI elobi nkita ekiti moke na RDC	rdc
Tshisekedi na Kabila balakani kopesa na maboko na bitumba na COVID-19	bokolongono / santé / medecine
Colonel John Tshibangu atiyami na bopemi ya monganga na Centre Nganda	rdc
Opposition parlemetaire epaleli bureau ya Ass. Nat. mpo kosenga bato batiama na CENI na bozangi ya mbongwana	politiki / politique
Ba Léopards bakweyi na ¼ de finale na Nigeria 46-79	rdc
Bato 15 bakosamba mpo na eyoma na Capitole	justice
Basembali ya Kamerhe ya France bapameli politiki na bosambisami mpe bamemi makambo na ONU	politiki / politique
Tshisekedi azuwi bokambi ya bitumba na Ebola na maboko	rdc
Nzanzu Kasivita alobi ntina nini apekisi botelemeli MONUSCO na Nord-Kivu	bokengi / securite
VOA60 Lingala 2 mars 2021	politiki / politique
Mbeba ya makoki ya bomoto emati na 10% na septembre na RDC	rdc
Marie-Josée Mengi mosungi ya Hamida Kamerhe atiami na bokangami	justice
Dr. Munyangi azwi ndingisa ya kobanda ba essais cliniques ya mono na ye	bokolongono / santé / medecine
Bato 14 nde bakufaki na likama ya engunduka na Tanganyika	rdc
Tshisekedi alaki kopikola système dictatorial ya Kabila	rdc
Sango ya le 8 août 2019 na 16h TU na VOA Lingala	rdc
"Nani azali na nsima ya passport ya RDC? emituni ""Congo ezali ya koteka te"""	politiki / politique
Bozongi ya nzoto ya Etienne Tshiskedi bozongisami nsima	rdc
Libota lya zuzi Yanyi eboyi bilembo bya autopsie	justice
Ba ONGDH bakebisi mpo na bozongi ya Bakata-Katanga na ba Maï Maï na Katanga	rdc
Bato motoba bakufi ntango Cour constitutionnelle endimi elonga ya Ouattara	politiki / politique
Macron azwami na COVID-19 [TOTALA NA Lingala]	bokolongono / santé / medecine
Biteni ya nzoto esusu bizwami bisika ya likama ya Antonov 72	rdc
Lieut.Gén. Ndima alobi ba FADRC bazali kokoba bitumba ata volcan Nyiragongo etomboki (Exclusivité VOA Lingala)	bokengi / securite
Gouverneur ya Haut-Lomami alobi bolongoli bwa ye botosi mobeko te	rdc
"Kamerhe atiami na ""respiration artificielle"" (Michel Moto)"	politiki / politique
Liwa lya Gén. Delphin Kahimbi: Tribunal etiki bato banso basambisamaki	justice
Tshisekedi asololi boyokani na ntoma ya Rwanda na Kinshasa	politiki / politique
Mbusa Nyamwisi azongi mboka	rdc
Bakonga akatelemi mibu misato ya boloko mpe mwana na ye sanza motoba	justice
"Ba ""Sages-femmes"" to Baye babotisaka babikisa bomoi ya ba mama na bana mingi [TOTALA]"	bokolongono / santé / medecine
Thambwe Mwamba atiki mosala	politiki / politique
Mayobo asakoli ete PALU ekoti Union sacrée ya président Tshisekedi	politiki / politique
VOA60 Lingala 13 avril 2021	politiki / politique
CENCO esengi maponami na ntango na 2023 mpe mbongwana na baye bakotiama na mbulamatari	politiki / politique
"FARDC ""esukisi"" koleka 6 bakambi ya ADF na babundi 80 na Beni"	rdc
Tshisekedi na milulu mya mibu 80 ya bosakoli Brazzaville lokola engumba ya France ya bonsomi	politiki / politique
Sassou, molongani wa ye na bayi mbulamatari bapesami mangwele ma COVID-19	bokolongono / santé / medecine
VOA60 Lingala 3 septembre 2020	justice
Néhémie Mwilanya ayanoli na mituna nsima na bokutani ya FCC na Kingakati	rdc
Tshisekedi na Ouganda o’mokolo mwa mposo	rdc
VOA60 12 septembre 2020	bokengi / securite
VOA60 Lingala 5 mai 2021	bokengi / securite
TGI epesi mposo moko na ngambo ya Kalev Mutondo nsima na bobandi bosambisami	justice
Bokono bwa maba bozali nanu kongala na RDC, elobi Dr. Ngondu	bokolongono / santé / medecine
VOA120 Lingala 24 juin 2020	bokengi / securite
"Tshisekedi : ""Boyakani na Kabila ekosalama kaka na botosi Etat de droit"""	rdc
VOA60 Lingala 18 juin 2020	justice
VOA60 Lingala 30 décembre 2020	bokolongono / santé / medecine
"Fibrome to bokono bwa ""myome"""	bokolongono / santé / medecine
"Kotanga nkombo ya Kamerhe na bato bakobima boloko ezali ""faute professionnelle"" (ACAJ)"	justice
Washington Forum: Déboulonnement Tshisekedi alakaki	politiki / politique
Brazzaville ekobanda kopesa mangwele ma COVID-19 na 20% ya bana mboka na 1er trimestre ya 2021	bokolongono / santé / medecine
Tshisekedi atie Kyungu mokambi ya SNCC mpe Yuma, ya Gécamines	rdc
VOA60 6 août 2020	bokengi / securite
Bilenge ya UDPS basengi boyokani CACH-FCC bokatana	rdc
LUCHA na Filimbi babengisi milulu mpo na kosenga bobengani bwa ntoma ya Rwanda	politiki / politique
Congrès endimi elonga ya Biden nsima na eyoma na Capitole	politiki / politique
Kankonde asengi bokangemi ya moko na bakambi ya ba Kamuina Nsapu na Kasaï C.	rdc
Bruno Tshibala atiki mokanda ya botiki mosala	rdc
Mbulamatari na FRPI bakoyokona mpo na kimya vendredi na Ituri	rdc
Fayulu azongi na Kinshasa	rdc
Moto moko amonani na coronavirus na Kinshasa	rdc
Cour d’Appel eboyi kobisima Kamerhe ata azali na lopitalo	justice
Katumbi azongeli compagnie na ye KMC na esika ya NB Mining	justice
Ba FARDC bazali kobengana ba CODECO nzinganzinga na Bunia (Lieut. J. Ngongo)	bokengi / securite
Etat de siège: Limpinga lya yambo ya basoda ya FIB ya MONUSCO likomi na Beni	bokengi / securite
Bakeli mibeko bakweyisi mokambi ya etuka ya Tshopo	politiki / politique
Tshisekedi abonzi Congo démocratique na maboko ya Nzambe	rdc
Evêque Mukuna atikami	justice
Lamuka ezali kodongwana mpo na libonga ya molobeli ya opposition	rdc
Ndimbola ya Dr. Aruna nsima na liwa lya mwasi moko na Ebola na Biena	bokolongono / santé / medecine
Kamerhe na Makala	justice
VOA60 Lingala 31 mai 2021	bokengi / securite
VOA60 1er juillet 2020	politiki / politique
COVID19 : OMS ekebisi Afrika na kolongola mikano ya makasi	bokolongono / santé / medecine
VOA60 Lingala 11 mars 2021	politiki / politique
Ba soda 60 bakufi na bitumba na ba ADF ba Beni	rdc
Balongi ya DV 2020 bapesameli nzela ya kosala mobembo sika na USA	politiki / politique
Bato mingi bakufi na bobukani ya mine na Kamituga na Sud-kivu	bokengi / securite
Kalev Mutond apameli basungi ya kala ya Kabila mpo bozangi bosembo	rdc
Jaynet Kabila azelamaki na boyoki bato ya Tshisekedi kasi akendaki te	politiki / politique
Volcan Nyiragongo : Baye bakimaki na bisika ya lisalisi bakobanda kozonga le 8 juin	bokengi / securite
Lolenge nini mapitalo ma Goma mazali	bokolongono / santé / medecine
VOA60 Lingala 10 décembre 2020	politiki / politique
Tshisekedi apaleli eyoma likolo na bapaya na Afrika ya ngele	rdc
"Ba unités nyonso etiami na ya police ""alerte maximale"" na Lubumbashi"	bokengi / securite
5.000 FC ya amende soki olati masque te na lieu public na Kinshasa (vidéo)	bokolongono / santé / medecine
Tshisekedi asengi basimba minduki banso batika bibundeli	rdc
Bokutani ya Tshisekedi na Kabila bozali kobongisama	politiki / politique
Kabila akutani na bakambi ba mangomba ya FCC na Kingakati	politiki / politique
Sango ya le 16 juillet 2019 na VOA Lingala	rdc
Nangaa awangani kaniaka	rdc
Balandi ya UDPS batomboki na Lubumbashi	rdc
Lloyd Austin akomi moyindo ya yambo ya kokamba Pentagone	bokengi / securite
Baike ya opposition baboyi elonga ya Sassou mpe balaki kokende na bazuzi	politiki / politique
CLC, Lucha, Filimbi mpe Congo débout babengisa botamboli lobi mpo na kotelemela boponami ya Malonda	politiki / politique
Moto ya mibale akufi na Ebola na Biena  (OMS)	bokolongono / santé / medecine
Pascal Lissouba awei na mibu 88 na France	politiki / politique
Germain Katanga moko na babundi ya Ituri abimi boloko	rdc
Serge Yhombi Opango akomi moto ya mibale ya kosenga Cour constitutionnelle kopoya elonga ya Sassou	politiki / politique
VOA60 Lingala 17 mars 2021	bokengi / securite
B’episkopo bakebisi ete maponami ma le 21 mars mazanga pole na Congo-Brazzaville	politiki / politique
ONU epaleli liwa ya mopanzi sango mpo na Ebola na Ituri	rdc
Ba démocrates babandi misala mya kokweyisa Trump yambo bokonzi na ye bosila	politiki / politique
VOA60 Lingala 17 avril 2020	bokolongono / santé / medecine
Bayi LUCHA batelemeli botiyami ya ba bourgmestres na mokano ya ba gouverneurs	rdc
COVID19 : Bakoni banso babiki; Beni, Butembo na Goma ebimi na confinement	bokolongono / santé / medecine
Fayulu, Bemba, Katumbi na Muzito basengi mbulamatari kokitisa lifuta na yango mpo na COVID-19	rdc
"Mobulu na Kasumbalesa nsima na bokangami ya Tshiswaka ya UDPS na ""Bilanga"""	bokengi / securite
Batongi bilamba bazali kosala ba masques na Bukavu mpo na kobundisa COVID-19	bokolongono / santé / medecine
Cardinal Ambongo asengi kotelemela mikano mya kokonza ba zuzi mpe mya kotia bakonzi ya CENI na makasi	politiki / politique
Trump andimi Etats-Unis epesa etumbu na CPI mpo na koluka kolandela ba soda ya Amerika	justice
Joseph Kabila azongi Kinshasa	politiki / politique
Tshisekedi alakisi ete alingi kopesa bilenge esika na kopona PM Sama Lukonde ya mibu 43 (Patrick Muyaya)	politiki / politique
Conseil ya sécurité ebakisi mobu mosusu na mandat ya MONUSCO	rdc
VOA60 Lingala 5 mai 2020	bokolongono / santé / medecine
Mokambi ya sika ya police asengi lisungi ya population na Lubumbashi	rdc
VOA60 Lingala 18 mars 2021	politiki / politique
CENCO esengi bakeli mibeko basala kaka te mpo na lingomba songolo te kasi mpo na démocratie	politiki / politique
"Mali : basoda bakangi président mpe PM ya transition kasi bakonzi bamolongo batelemeli ""coup d'état"""	bokengi / securite
Bokutani ya bakonzi ba bikolo ba CIRGL mpo na RCA na Luanda	bokengi / securite
Hamed Bakayoko Ministre wa yambo ya Côte d’Ivoire awei na Allemagne	politiki / politique
FMI elobi kokitisa budget ezali malamu	rdc
VOA60 Lingala 23 avril 2021	politiki / politique
Museveni alaki CENCO kosunga kosilisa basimba minduki	rdc
CCT ekebisi mpo na balkanisation (bokatani) ya RDC	rdc
Sassou atie matanga na mboka mpo na Yhombi Opango vendredi	politiki / politique
Patricia Nseya candidate ya UDPS na esika ya Kabund na ebonga ya 1er V-P ya Assemblée nationale	politiki / politique
VOA60 Lingala 6 mai 2020	bokengi / securite
Kamerhe azelami na Parquet général	justice
Tshisekedi akomi Goma	politiki / politique
Trump akebisi Biden na komisakola molongi na lombango	politiki / politique
Tshisekedi na Museveni bapeti piololo ya bobandi botongi nzela ekosangisa Ouganda na RDC	politiki / politique
Dr. Muyembe alimboli mangwele ya mibale ya Ebola	rdc
Tshisekedi alobi alingi mokonzi ya kala avanda na kimya mpo ye mpe akokoma mokonzi ya kala	politiki / politique
VOA60 Lingala 24 mai 2021	bokengi / securite
voa60 Lingala 2 octobre 2020	bokengi / securite
Ba ONG basengi Tshisekedi etumbu mpo na Dan Gertler	rdc
Soda moko abomi bato zomi na misato na Sange, na Sud-Kivu	bokengi / securite
Bakata Katanga 16 bakufi elongo na ba policiers babale na soda moko na bitumba na Lubumbashi	bokengi / securite
Pascal Mukuna atindami na Makala	justice
Ba ADF babmomi lisusu bato babale na Oicha	rdc
Bato bazoki na masasi na milulu ya kosenga bokengi mpe bolongwi ya Monusco na Beni	bokengi / securite
Katumbi alobi atambolaki te mpo aboyaki makila matanga	politiki / politique
Poloice epanzi balandi ya Pascal Mukuna na ACK/Bandal	justice
Tshisekedi asengi moto nyonso mpe mboka nyonso kopesa eyano na boluki kimya no mokili	rdc
Gims ayanoli na mituna ya VOA Lingala	rdc
Tshisekedi akomi na Nairobi mpo na bokutani ya ACP	rdc
Fayulu asengi etumbu mpo na bobomami ya Kipupu mpe bolukiluki ya bayi molongo	bokengi / securite
Tshisekedi akitisi mitema na babeli ya COVID na hôpital ya Cinquantenaire	bokolongono / santé / medecine
VOA60 Lingala 25 janvier 2021	politiki / politique
VOA60 14 août 2020	bokengi / securite
Thomas Lubanga alongwe kati na bato ya etumbu ya ONU	justice
Ba Léopards babetami lisusu fimbu na CAN 2019 na ba Pharaons (0-2)	rdc
Sango ya le 20 mai 2019 na VOA Lingala	rdc
Lisungi mpo na basi bazali na mpasi kati na bomwasi na bango (endométriose) na Kinshasa	bokolongono / santé / medecine
"""15 millions $"" : Procureur ya Cour ya cassation apekisi makelele, azwi makambo na maboko"	rdc
VOA60 Lingala 28 avril 2020	bokengi / securite
VOA2X60 Lingala 1er aout 2020	politiki / politique
VOA60 Lingala 22 mars 2021	bokolongono / santé / medecine
Nangaa akutani na ba 13 parlementaires bazali kosenga mbongwana na mapopnami	politiki / politique
Sassou na Tshisekedi bakutanaki na Oyo	rdc
Ba Maï Maï babale bakangami na botelemeli MONUSCO na Butembo	rdc
VOA60 26 mars 2020	bokolongono / santé / medecine
Pierre Buyoya atiki ebonga na ye ya molakisi elongi ya UA na Mali mpo asamba	politiki / politique
S/Sec d'Etat adjointe ya Amerika apeski maboko na bokengi na Lubumbashi	rdc
COVID-19: Dr. Mukwege alobi bana ya Afrika basalela makoki ya mboka na bango	bokolongono / santé / medecine
Basango ya le 2 avril 2019 na 16h TU na VOA Lingala	rdc
VOA60 Lingala 16 février 2021	politiki / politique
Etumbu ya liwa mpo na minganga bafundamaki na liwa lya Dr. Richard Muzoko ya OMS na Butembo	justice
LICOCO esenge bokangami ya bato basusu bazali na misala ya 100 jours ya Tshisekedi	rdc
VOA60 Lingala 12 mars 2021	bokengi / securite
Minembwe : Bakeli mibeko bakati ete Ruberwa ayanola na mituna na bango	politiki / politique
Bakeli mibeko ya mboka bapameli Ministre wa Yambo na kolakisa mawa te mpo na basi mpe bana ba Beni	bokengi / securite
Koleka bato 15 bakufi na likama ya bwatu ba lac Maï-Ndombe	rdc
N’Sengi-Biembe azuwi ebonga ya Ibenge	rdc
Mwana ya président ya kala ya Angola José Filomeno dos Santos akatelami mibu mitano ya boloko	justice
Guterres asololi likambo ya mbongwana ya ba institutions na Lamuka	rdc
Bavandi ya Beni bakotaki nzamba koluka ba ADF na makwangola kasi ba FARDC babomi ba ADF 8	bokengi / securite
"Tshisekedi : ""libala FCC-CACH ezali kokende na kokufa te"""	politiki / politique
Kagame, Museveni, Lourenço na Tshisekedi bandimi lisusu kosangisa makasi mpo na kosukisa basimba minduki	bokengi / securite
Ba ADF babomi bato zomi na wenze moko na Ituri	bokengi / securite
Basoda babengani bayi UDPS na post-frontalier ya Kasumbalesa	bokengi / securite
Ne Mwanda Nsemi abimisami na boloko	rdc
Mokambi ya kala ya ANR Kalev Mutond abengisami na jeudi na parquet général	bokengi / securite
Théodore Ngoyi alobeli ndenge ANR ebuki bureau ya président ya Cour constitutionnelle	justice
"Tshisekedi asakoli suka ya libala CACH-FCC mpe akotia na esika ""Informateur"" mpo na koluka majorité ya sika"	politiki / politique
VOA60 Lingala 11 juin 2021	politiki / politique
VOA60 Lingala 12 mai 2021	politiki / politique
VOA60 8 août Lingala	politiki / politique
"Sylvestre Ilunga alobi akokende te kolia epayi ya ba ""voisins"""	politiki / politique
Mbela ya ba banyamulenge na Tshiluba	rdc
DG Blattner ya Safricas akatelami mibu 20 mya misala makasi na bosambisi bwa bozongeli	justice
Foto ya touriste ya mondele amemami na tipoy ebendi nkanda	rdc
Liwa lya Attanasio: Molobeli ya ba FDLR Cure Ngoma alobi ezali mampinga ma Rwanda na ma RDC	bokengi / securite
Police epanzaki bato babandaki kotambola mpo na kosenga bolongwi ya gouverneur ya Tshopo	politiki / politique
Tshisekedi alobi RDC ekopesa yambo mino mibale mikelami na mboka mpe ekozela mpo na mangwele	bokolongono / santé / medecine
Koffi Olomide akosambisama lisusu na France na avril 2020	rdc
Jonathan Bolingi alobi elikya ezali mpo na ba Léopards	rdc
VOA60 Lingala 16 avril 2021	politiki / politique
Sassou na Moussa Faki basololi mpo na kimya na Afrika	politiki / politique
Police ekangaki ba bureaux mpe ebenganaki basali ya Assemblée na Kisangani (vidéo)	politiki / politique
VOA60 Lingala 1er avril 2020	rdc
Ilunga na mbulamatari na ye bandimami na Assemblée nationale	rdc
Tshisekedi alobi likambo lya Minembwe likotalama yambo na bato ya mayele	bokengi / securite
VOA60 Lingala 22 décembre 2020	justice
VOAl60 Lingala 20 janvier 2021	politiki / politique
Trump alobi akoki kozonga na bokonzi na 2024	politiki / politique
Ba députés pene na 200 bakebisi koboya mbulamatari ya Sama Lukonde (Daniel Mbau)	politiki / politique
VOA60 Lingala 25 décembre 2020	bokengi / securite
VOA60 Lingala 6 mars 2020	rdc
VOA60 Lingala 19 octobre 2020	politiki / politique
23 ADF bakufi na bitumba na Mavivi na Beni	rdc
Basali ya bitumba na Ebola na COVID19 batiaki moto na esika basalaka na Mbandaka mpo na lifuta	bokolongono / santé / medecine
VOA60 6 avril 2021	politiki / politique
Nkanda ya PM Ilunga mpo Tsisekedi atindaki ya Lubumbashi mpe Kankonde atiaki manzaka na mikanda	politiki / politique
Tshisekedi alobi ezali malamu Kagame atinda bato basala mabe na justice mpe akumisa Dr. Mukwege	politiki / politique
Ruberwa akoyanola na Parlement mpo na nini akomisi Minembwe commune (Député Mohindo)	politiki / politique
Bato motoba bakufi mpe minganga mibale bamemami na bitumba ya ba ADF	rdc
Peintre mpe mosali bikeko Roger Botembe awei	rdc
Mobulu na campagne électorale mpo na ba gouverneurs na Lubumbashi	rdc
Ndako ya ntalo ya Denis Christel Sassou ekangami na bazuzi na Miami	bokengi / securite
VOA60 Lingala 12 avril 2021	bokolongono / santé / medecine
Koffi Olomide afundi baye bakangaki ye	rdc
"Daniel ""Massaro"" na parquet ya Cour d’appel ya Matete"	justice
Kolata masque ekomi lotomo na Sud-Kivu nsima na moto ya misato ya COVID-19	bokolongono / santé / medecine
Amerika epesi etumbu na procureure Fatou Bensouda ya CPI	justice
Trésor américain epesi etumbu na Musa Baluku mokonzi ya ba ADF na mitano misusu	rdc
Eyeno ya boko ba députés ya PPDR na mobulu mosalamaki na Kinshasa	politiki / politique
Kenya elingi kokanga ba camps epayi wapi bakima bitumba koleka 400.000 bazalaka	bokengi / securite
Koleka bato zomi bakufi na likama ya mayi na Kasaï	bokengi / securite
Félix Félix Tshisekedi na bakonzi basusu na matanga ma Idriss Deby na N'Djamena	politiki / politique
"Gouverneur Banisa alobeli ""état de siège"" na Ituri"	bokengi / securite
Bakangami bakimi boloko ya ANR nsima kofina nkingo ya mobateli na bango na Lubumbashi	bokengi / securite
Mokambi ya ba Maï Maï Mulangane akitisi minduki na babundi baye 120 na Walungu	bokengi / securite
Ngoyi Mulunda na ba avocats baye basengi appel na boloko ya Kasapa [TOTALA]	justice
Néhémie Mwilanya ayanoli mpo etali botelemeli ya Lamuka	rdc
Diomi Ngongala abimi na boloko	rdc
VOA60 Lingala 5 septembre 2020	bokengi / securite
VOA60 Lingala 28 septembre 2020	bokengi / securite
Etats-Unis ezongeli boyokani mpo na bokengi na RDC	bokengi / securite
TGI Kinshasa/Gombe etie plaidoirie le 11 juin nsima na koyoka banzeneneke banso na procès Kamerhe	justice
Pene na bato motoba bakufi na bitumba ya Bakata Katanga na Lubumbashi	rdc
Ba Léopards ya basi ya basketball na groupe C ya Afrobasket	rdc
Bazuzi babale ya Cour constitutionnelle batelemeli botiami na bango na Tshisekedi na Cour ya Cassation	justice
Sango ya le 24 juin 2019 na 16 TU na VOA Lingala	rdc
Kobika na bokono bwa sida	bokolongono / santé / medecine
Milulu mingi mpo na kosenga TPI mpo na RDC mibu 10 nsima na rapport mapping	justice
Mbulamatari epekisi kotimola minerais na maboko na esika bato pene na 50 bakundamaki na Kamituga	bokengi / securite
Zambie-RDC na bokutani na Lubumbashi mpo na basoda zambiens na mabele ma Congo	bokengi / securite
FARDC ezongisi nzoto ya soda ya Angola akufaki na masasi Kasaï	bokengi / securite
Bosambisami mpo na liwa ya ba experts ya ONU ezongeli nisma na sanza 6	justice
Ba commandants babale ya FARDC na Beni mpe Ituri babengisami na Kinshasa	rdc
Nzoto ya Etienne Tshisekedi ekonzonga le 30 mai	rdc
Tunisie na Angola bakaboli 1-1	rdc
VOA60 Lingala 10 octobre 2020	politiki / politique
VOA60 Lingala 30 avril 2020	bokengi / securite
Moyi Guinée Bintou Keita atiami mokonzi ya ONU (MONUSCO) na esika ya Zerrougui	politiki / politique
Bilenge ya Kabila balobi bazali bomoko na bato ya Beni	rdc
VOA60 Lingala 16 juin 2020	justice
Tshisekedi asembeli mpo na kimya na mboka, bofulukisami mpe ntombwa na 2021	politiki / politique
MONUSCO ekobanda kolongwa moke moke mpe ekotikalaka na Nord-Kivu, Sud-Kivu mpe Ituri	bokengi / securite
Koleka bato 20 bakufi na bitumba na Ituri	rdc
Ba soda ba pulusu na bayi bokengi bakopona mokonzi mboka mercredi na Congo-Brazzaville	politiki / politique
Muhindo Nzangi asengi Ruberwa kotika mosala mpo akosaki	politiki / politique
Basango ya le 22 mars 2019 na 16h TU na VOA Lingala	rdc
Sango ya le 13 août 2019 na 16h TU	rdc
Guterres alaki ete basimba minduki bakolimwa na Beni na lisungi ya Monusco na ba FARDC	rdc
VOA60 Lingala 3 août 2020	politiki / politique
VOA60 Lingala 10 septembre 2020	justice
Prince Philip ya Royaume-Uni akufi na mibu 99	politiki / politique
Pene na bakengemi 30 ya ba ADF/Etat islamique batikami	rdc
Ilunga Makabu, champion du monde ya Boxe	rdc
Kizunguzungu ntago ya zemi	bokolongono / santé / medecine
COIVD19 emati makasi na Madagascar ata nkisi ya Artemisia esalamaki kuna	bokolongono / santé / medecine
Conseil d'Etat ekoti kinzonzi na bosambisi ya Kabund na Mabunda mpo na ebonga ya 1er v-p ya Ass. Nat.	justice
Basango ya le 21 mars 2019 na 16TU na VOA Lingala	rdc
Auditorat esilisi enquête ya liwa ya Chebeya mpe elingi kosenga bosambisami ya John Numbi	justice
Kamala Harris azwi mangwele ya Moderna	bokolongono / santé / medecine
Ilunga Ilunkamba aponami Premier ministre	rdc
Nkanda ya UDPS nsima na bobimisami ya gouvernement provincial ya Haut-Katanga	rdc
Tshisekedi asengi babundi bakitisa minduki mpo bakozwa misala na Sake (Vidéo)	bokengi / securite
Bakoni basato basusu bazwami na Ebola na Butembo	bokolongono / santé / medecine
Agent ya santé azwaki vaccin abeli Ebola	rdc
VOA60 Lingala 21 avril 2021	justice
Basali ya laboratoire ya COVID19 na Ebola batelemisi mosala na Mbandaka (Vidéo)	bokolongono / santé / medecine
Bato basato bakufi na bokweyi ya mpepo na Kavunu	bokengi / securite
Bahati Lukwebo aponami mokambi ya Sénat lokola mpe Michel Kanyimbu bo’ rapporteur	politiki / politique
VOA60 Lingala 20 mars 2020	rdc
"Katumbi akomi Kin mpe atondi ba Kinois mpo bapekisaki ""faux penalty"""	politiki / politique
VOA60 13 octobre 2020	politiki / politique
Tshisekedi asengi FARDC etiya QG na Beni mpe esala elongo na Monusco	rdc
Trump apesi makanisi ya kopusa maponami ma le 3 novembre	politiki / politique
VOA60 Lingala 4 septembre 2020	justice
Minganga batamboli mpo na kotelemela bobomi ya moko na bango na Butembo	rdc
Assemblée nationale elobi ekokoba na linaka ya maponami ya 1er vp ata Conseil d’Etat eboyi	justice
Masasi mabetami na ndako ya Moïse Katumbi na Lubumbashi	bokengi / securite
Ba mouvements citoyens batamboli mpo kosenga mbongwana na misala mya maponami	politiki / politique
COVID-19: Ndenge bayi Beni balekisi mokolo mwa pasika	bokolongono / santé / medecine
Cour constitutionnelle elobi état d’urgence esakolami lolenge buku likonzi lisengi	justice
Moto azuwamaki na Ebola na Goma azongisami na Butembo	rdc
VOA60 Lingala 29 octobre 2020	bokengi / securite
USA lokola mpe mbulamatari ya Nigeria bandimi nanu te liwa lya Shekau, mokambi ya Boko Haram	bokengi / securite
Etat de siège: Koleka bato 54 babomami na basimba minduki na Boga mpe Tchabi na Ituri	bokengi / securite
Nzoto zomi ezwami nsima na bitumba ya ba Ngumbino na ba Twirwaneho na Fizi	bokengi / securite
Bemba, Fayulu, Katumbi na Muztio batomboki mpo na Ass. Nat. endimi boponami ya Malonda na kokamba CENI	politiki / politique
VOA60 Lingala 28 novembre 2020	politiki / politique
Bato 11 bakatemi mitu na batomboki na Alungupa na Beni	rdc
Sango ya le 9 mai 2019 na VOA Lingala	rdc
VOA60 Lingala 1er mai 2021	bokengi / securite
Ba Sénateurs baike ya FCC basengi Kabila bolongwi ya batambwisi ya lingomba na bango	politiki / politique
Sango ya le 30 mai 2019 na 16h TU na VOA Lingala	rdc
Bato basato bakufi na mobulu kati na police na bayi Ne Muanda Nsemi na Boma	bokengi / securite
Président Mokwetsi Eric ya Botswana na Tshisekedi bayokani kokolisa bondeko kati na bikolo na bango	politiki / politique
Tshisekedi na bisika ba sauts-de-moutons bizali kongama	rdc
VOA60 Lingala 27 mars 2021	politiki / politique
Sango ya le 2 juillet na VOA Lingala	rdc
Dr Mukwege alongwe na bokambi bitumba na COVID19 na Sud-Kivu	bokolongono / santé / medecine
Godefroid Mayobo andimami na ministère ya Intérieur bo' mokambi ya PALU	politiki / politique
Mampinga ya Amerika makosunga ba FARDC na bitumba na ba ADF	rdc
Mokano ya Cour constitutionelle ekei ngambo ya TGI eye epesaki elonga na Albert Yuma	justice
Hélicoptère ya FARDC ebungi na ba officiers na Ituri	bokengi / securite
Moto wa yambo akufi na COVID19 na Kinshasa	rdc
Bosambisami bwa Trump bobandi kasi basambeli ba ye balobi akozala te mpo asi alongwa	politiki / politique
Conseil d’Etat etelemisi bolongolami ya Kabund na linaka ya maponami ya 1er vp ya Ass. Nat.	justice
VOA60 Lingala 14 octobre 2020	politiki / politique
Liyebisi lya kafu kafu lya mbulamatari ya RDC mpo na mangwele ma COVID-19 lelo (Dr. Eteni)	bokolongono / santé / medecine
Trump abiki nsima na kosambisama mpe akoki lisusu kopesa nkombo na maponami makoya	politiki / politique
Bakambi ya Japon balaki Tshisekedi kozongela boyokani ya makasi	rdc
Banyemulenge basengi boyokani nsima na maloba ya Tshisekesi	rdc
Bato 15 batiyami na quarantaine na Bukavu	rdc
Bato pene 100 bazalaki kozanga nsima bozindi ya bwatu na lac Kivu, na Kalehe	rdc
Cour constitutionnelle ednimi elonga ya Sassou	politiki / politique
OMS ekebisi mokili mpo na kobosana Ebola likolo ya Coronavirus ya sika	rdc
Directeur financier ya maison civile ya Tshisekedi atindami na Makala	justice
Bayi Ne Mwanda Nsemi balobi bakufisi mitano kasi police elobi eza lokuta	rdc
VOA60 Lingala 17 mai 2020	justice
VOA60 Lingala 2 juin 2020	politiki / politique
Macron ayebisi Tshisekedi ete asepeli ndenge makambo mazali kokende na RDC	politiki / politique
Jacques Mugabo moko na ba policiers batanga na liwa ya Chebeya na Bazana akangami na Lubumbashi	bokengi / securite
Lucha etamboli mpe esambeli mpo bosolo ezala na maponami na Beni	rdc
Bayi UNC motoba bazoki na milulu mpo kosenga botikami ya Kamerhe na Bukavu	justice
Bokweyisami ya Mabunda na bililingi [TOTALA]	politiki / politique
Ba Antibalaka (Centrafrique) babomi koleka 50 bato uto janvier na Nord-Ubangi	rdc
Sango ya le 3 juillet 2019 na VOA Lingala	rdc
Minganga batamboli mpo na kosenga prime ya risque na Bukavu	rdc
VOA60 Lingala 10 avril 2021	politiki / politique
Pene na 700 mbeba ya makoki mabomoto masalami na mars (ONU)	rdc
Nkanda na likita ya mbulamatari mpo na eyano ministre ya bosembo apesi Assemblée Nationale	politiki / politique
Jacques Chirac azalaki moninga ya Mobutu, etatoli Mokonda Bonza	rdc
Ba ADF babomi lisusu bato koleka 22 na Beni (TOTALA)	bokengi / securite
Sit-in ya ba agents ya Monusco na Lubumbashi	rdc
Milulu ya mobu moko ya bokonzi ya Tshisekedi na Lubumbashi	rdc
Fayulu asengi na bakambi ya Amerika batosa bonsomi ya bana ya RDC	rdc
VOA60 Lingala 17 décembre 2020	politiki / politique
Tshisekedi atie bakonzi ya sika bayike na misala ya bosembo	rdc
Moto wa yambo azwami na COVID-19 libanda ya Kinshasa, na Ituri	rdc
Bitumba kati na balandi ba Trump na basusu yambo na Collège electoral kopona lundi	politiki / politique
Lisikulu lya Tshisekedi mpo na Ekolo liboso lya Congrès [TOTALA]	politiki / politique
Tshisekedi akomi na Abuja	rdc
Opposante Yvonne Iryamugwiza akangami na Rwanda	bokengi / securite
Bakati nzela babomi bato minei na Kasangulu	rdc
Sango ya le 12 juin 2019 na 16 TU na VOA Lingala	rdc
Tshisekedi na Kabila bakutanaki o'mokolo mwa lomingo (FCC)	politiki / politique
Koleka bato 100 bakufaki na explosion na beyrouth	bokengi / securite
Ndenge bato bazali komibatela na COVID-19 na Bunia	bokolongono / santé / medecine
Koleka bato 41 bawei na mpela ekasi na Kinshasa	rdc
Olenghankoyi alakisi Ne Mwanda Nsemi na bapanzi sango	rdc
Mpela ekasi ebomi pene na bato libwa na Kasaï	rdc
Washington Forum	rdc
Fayulu asengi boycott ya Parlement mpe alobi ba manifestations ebandi	rdc
Bakoni ba COVID-19 bakomi 30 na Kinshasa	rdc
VOA60 Lingala 20 mars 2021	politiki / politique
VOA60 30 juillet 2020	politiki / politique
Sassou andimami na PCT mpo na kopesa nkombo na maponami ya mars 2021	politiki / politique
Katumbi akiti na aéroport ya Lwano	rdc
Mokambi ya etuka ya Kasaï oritnetal Jean Maweja akweisami	politiki / politique
FCC ekokutana na Tshisekedi kaka na ba structures ya mibeko mpe ya boyokani (Kambere)	politiki / politique
Tshisekedi asepeli na lisungi mpe boyokani na France	rdc
Justice militaire epesameli enquête ya bitumba ya Bakata Katanga (G. Kankonde)	bokengi / securite
VOA60 Lingala 3 mai 2021	justice
"""Massaro"" Daniel Shangalume aboyi koyanola na parquet mpe atindami Makala"	justice
"OMS elobi Ebola na RDC ezali ""urgence"" ya molongo"	rdc
Dr. Oly ilunga asimbami na police	rdc
Bakambi ba AFRICOM balaki kosunga FARDC na bitumba na Groupe Etat islamique	bokengi / securite
PGR afungoli bolukiluki likolo ya misala ya 100 jours ya Tshisekedi	rdc
Ba infections ya nzela ya bomwasi	bokolongono / santé / medecine
Président Kaboré alongi maponami mpo na kotikala mokonzi ya Burkina Faso	politiki / politique
Tshisekedi akomi Beni	rdc
Tshisekedi alobi alongi nanu te mpo kimya ezali te na monyele ya RDC (Sheik Fita)	bokengi / securite
VOa60 Lingala 16 mars 2021	politiki / politique
Basoda bakimi Kamina te kasi batindami nde Kasaï central, elobi bakonzi ya ba FARDC	bokengi / securite
Tshisekedi asololi na PM ya Japon, na bakambi ya Toyota na Mitsubishi mpo na Inga	rdc
CPI eboyi kofuta Jean-Pierre Bemba mosolo mpo na boloko ya pamba	justice
Ndambo ya lisikulu ya Félix Tshisekedi liboso ya Congrès (na Lingala)	rdc
Sango ya le 1er juillet 2019 na VOA Lingala	rdc
RDC ekeyi na ngambo ya baye bandimi Sahara Occ. Bo’ mabele ma Maroc	politiki / politique
VOA60 Lingala 11 juin 2020	justice
Général Peter Tchirimwami azwi ebonga ya bokambi bitumba na ADF na Beni	bokengi / securite
VOA60 Lingala 2 novembre 2020	politiki / politique
COVID19 : Tanzanie epesi etumbu na mokambi ya loboratoire mpo na ba résultats ya mabe	bokolongono / santé / medecine
Moto ya mibale akufi na COVID-19 na Kinshasa	rdc
"Katumbi na bayi ""Ensemble"" na likita mpo na kokela parti ya sika"	rdc
Bokono bwa loposo ya ba ndundu	bokolongono / santé / medecine
"""Sika blocage eza te Sama Lukonde na mbulanmatari basala, soki bakoki te bakozongisa bokonzi na Kabila na 2023"", Nzekuye"	politiki / politique
FARDC epesi baloni ndingisa ya kokota Mwalika nsima na kobotola yango ba ADF	rdc
Police ebetaki ba journalistes baike na botambaoli na Kisangani	politiki / politique
Muzito alobi aboyi mampinga ya bapaya mpe asengi ONU Tribunal pénal mpo na RDC	politiki / politique
VOA60 Lingala 16 septembre 2020	politiki / politique
Moïse Katumbi alobi azwi epakolami ya Goma mpo na kosala parti na ye	rdc
Sylverte Ilunga, Premier ministre	rdc
Parquet général ya Cour d’appel ya Gombe ebengisi lisusu Kalev mardi	justice
Moto monene na entredépôt ya carburant na Kinshasa mpe na Kananga	rdc
Ba alliés ya UDPS basengi Tshisekedi apesa bango Primature	rdc
USA na RDC batie manzaka mpo na boyokani ya mambi ma mampinga	bokengi / securite
Sango ya le 14 août na 16h TU na VOA Lingala	rdc
VOA60 Lingala 14 avril 2021	justice
Trump aboyi kozala na bolapi ndayi ya Biden	politiki / politique
VOA60 Lingala 29 septembre 2020	bokengi / securite
Bemba asengi na bakeli mibeko ya MLC basala maseki te mpo na mbongwana ya maponami	politiki / politique
Assemblée nationale ekokende loyi te mpo na Etat de siège	politiki / politique
J-P Bemba na MLC bakanisi mibu 21 ya lingomba na bango na Kisangani (bilili)	rdc
Bukanga Lonzo: Matata Ponyo alaki komema makambo na bazuzi	justice
VOA60 Lingala 3 octobre 2020	politiki / politique
Banyamulenge basengi bokengi na ONU	bokengi / securite
Tshisekedi akozwa maloba na 75e Assemblée générale ya ONU mardi	politiki / politique
VOA60 Afrique 14 novembre 2020	politiki / politique
Tshisekedi apesi losako ya suka na directeur adjoint ya Communication na ye Kilosho	bokolongono / santé / medecine
Kalaka mokonzi ya Sénat abengisi likita mpo na kotia Bureau d’âge	politiki / politique
Police ebomaki 55 balandi ya Ne Muanda Nsemi bakufi, elobi HRW	bokengi / securite
VOA60 Lingala 8 mars 2021	politiki / politique
Landa Litatoli lya baye balobi bazalaki na bobomi ya Chebeya na Bazana (Partie 1)	bokengi / securite
Abdullahi ya Somalie asengi Tshisekedi kosunga bayi mboka na ye koyokana	bokengi / securite
Lissouba akokundama mpo na mwa ntango le 31 août na Paris	politiki / politique
Inspection Générale ya Finances etindi audit ya misala ya COVID19, ministère ya bokongono na IRNB	justice
Bisaleli ya bitumba na Ebola biyibami na Kisangani	rdc
VOA60 Lingala 23 décembre 2020	politiki / politique
Sango ya la 18 juin 2019 na 16h TU na VOA Lingala	rdc
Kamerhe akoti lopitalo	justice
VOA60 Lingala 18 février 2021	bokengi / securite
VOA60 Lingala 24 février 2021	politiki / politique
Ne Muanda Nsemi atindami CNPP	bokengi / securite
Colonel John Tshibangu akobima boloko samedi (Eccha)	rdc
Bahati Lukwebo alobi akotambola ye moko na lingomba na ye AFDC-A (Interview)	rdc
Bobimi na boloko ya col. John Tshibangu bozali na maboko ya Haute cour militaire	rdc
Sango ya le 31 juillet 2019 na 16h TU na VOA Lingala	rdc
Biden azwi mangwele ya COVID-19	bokolongono / santé / medecine
Matata Ponyo afundi mokambi ya IGF Jules Alingete	justice
VOA60 Lingala 4 mars 2021	bokolongono / santé / medecine
Bavandi batomboki na lopango ya Monusco ya Beni	rdc
F. Tshisekedi alaki kotiya manzaka na boyokani ya UA ya bitumba na kaniaka	rdc
Sassou abengisi likika ya CEEAC samedi mpo na matata na Centrafrique	politiki / politique
Tshisekedi na masolo na Aleksandar Vučic na Belgrade (Serbie)	rdc
Vague ya misato ya COVID-19 na RDC esakolami na Ministre ya Santé	bokolongono / santé / medecine
Mabunda akweyisami nsima na maponami	politiki / politique
VOA60 Lingala 24 mars 2021	bokengi / securite
Société civile esengi PM belge bolongwi na FARDC ya bakambi bafundama na mbeba	rdc
Bokengi botiami na bokebi mpo balandi ba Trump bakoki kovandisa ye na bokonzi lelo na Washington	bokengi / securite
Tshisekedi apesi mibeko mbulamatari efuta mosolo mpo na baye ya likama ya Lufu	rdc
VOA60 Lingala 5 novembre 2020	politiki / politique
Eddy Kapend na basusu babimi kasi etumbu na bango elongwe te (Me Willy Wenga)	justice
VOA60 Lingala 21 mars 2020	rdc
Gaz lacrymogène nsima na bokomi ya Kamerhe na Cour d’appel ya Matete/Limete	justice
"""Na Bozindo"": Kambere alimboli ndenge FCC etelemeli botiami ya Bahati bo' ""Informateur"""	politiki / politique
Thomas Lubanga abwaki mbela na bubundi mpo na bakitisa minduki na Ituri	bokengi / securite
VOA60 Lingala 30 septembre 2020	politiki / politique
VOA60 Lingala 26 mars 2021	bokolongono / santé / medecine
COVID19 : Richard Muyej abengisi losambo ya sanza mibale na Lualaba	bokolongono / santé / medecine
Bemba, Fayulu, Katumbi mpe Muzito baboyi bayi bureau ya CENI ya kala bazonga	politiki / politique
Etat de siège: Tshisekedi atie ba officiers ya police na bibonga ya ba Maires na Nord-Kivu mpe Ituri	bokengi / securite
Sénatrice Goya aboyi kolongola plainte contre Thambwe Mwamba	justice
MLC elobi balandela mpe kaniaka na ntango ya mponami ya président	rdc
Mposo ya kosunga bato kotalisa nzoto mpo na VIH/SIDA, COVID-19 mpe Hépatie ya ofele	bokolongono / santé / medecine
Basango ya le 20 mars 2019 na 16h TU na VOA Lingala	rdc
Nzoto ya Tshisekedi ekiti na Kinshasa	rdc
Monusco ebakisi bibundeli mpe esengi kimya na bana ya Hauts Plateaux na Sud-Kivu	rdc
Ba ONG basengi balendela Nandaa nsima ya bofundami ya Washington	rdc
Bana ya RDC bakanisi bobomami ya bandeko na bango na RDC, na milulu na Washington mpe bisiki mingi	politiki / politique
Démocrate mosusu afundi Trump mpo na eyoma na Capitole	justice
Volcan Nyiragongo: Mbulamatari epesi OVG makoki ya kosala mosala ndenge esengeli (Patrick Muyaya)	bokengi / securite
VOA60 Lingala 6 janvier 2021	politiki / politique
"UDPS ekebisi bato bazali komemisa yango mokumba ya ""milice"" ekangami na Kingabwa"	politiki / politique
Mobulu na Likasi mardi nsima basimba mibuki kobama bayi libota lyoko na Likasi	bokengi / securite
Ba Alliés ya UDPS basengi matata masila kati na CACH na FCC	rdc
Sassou Nguesso akomi na Kinshasa mpo na matanga ya Tshisekedi	rdc
Cour internationale ya justice ekotinda ba experts mpo na kotala motuya ya mbeba Ouganda esala na RDC	justice
"""Motion de censure"" mpo na bolongwi ya Néron Mbungu mokambi molandi ya Kinshasa"	politiki / politique
Pompeo alaki lisusu Tshisekedi lisungi ya USA	rdc
240 miliciens ya CODECO batiki minduki kasi FARDC ekokoba offensive na Ituri	rdc
Police epanzi batombali ya Lamuka	rdc
Mikolo ya ba FDLR mizali ya kotanga, eyanoli Sec. d’Etat ya Rwanda	rdc
"""Tshisekedi na Kabila bakobima na lifelo kaka soki bandimi maponami misusu"" (Muzito)"	rdc
Communauté Congolaise ya Etats-Unis ebengisi marche na Washington le 17 janvier	rdc
"Tshisekedi : ""nga na bokonzi, mboka ekokatana te"""	rdc
Chine elongoli nyongo ya 28 millions $ ya RDC mpe elaki 17 millions $ na lisungi na bokambi UA	politiki / politique
Bakambi ya Lamuka balobi batikali lisanga mpe bakokoma plateforme ya politiki	rdc
Biden apameli Trump na kolekisa ntango na ye ya kobanda kobundisa COVID-19	bokolongono / santé / medecine
Coromavirus emonani na bato 14 na Kinshasa	rdc
Prof Ekwalanga azokoma Kin mpo na kosala na Dr. Munynagi na basusu na bitumba na COVID19	bokolongono / santé / medecine
Ba sado ya Ouganda babomi bato babale na lac Albert	bokengi / securite
Tshisekedi na molangani wa ye batombeli bana RDC eyenga botama mpe mobu molamu	rdc
Mokambi ya ba FARDC apameli ba Maï Maï mpo na kobundisa misala mya Ebola	rdc
Maponami ya ba gouverneurs matiyami le 10 avril	rdc
TP Mazembe ekokutana na Raja CA na ¼ ya finale	rdc
Lingomba Etat islamique elobi yango nde libuki boloko ya Kangbayi (Beni) [TOTALA]	bokengi / securite
Bokono bwa cancer ya bana	bokolongono / santé / medecine
FMI epesi pene na 369 millions $ crédit d’urgence	rdc
"Pierre Lumbi atiami SG ya ""Ensemble pour la république"", parti ya Katumbi"	rdc
OVG ekebisi ete bato bakufa na botomboki ya volcan Nyiragongo kosangana na ba gaz ya lac Kivu	bokengi / securite
VOA60 Lingala 1er février 2021	politiki / politique
Félix Tshisekedi, Kagame na Joao Lourenço na matanga ya Etienne Tshisekedi	rdc
Espoir Ngalukiye alobeli projet oyo amemi na Fellowship Mandela Yali 2019	rdc
Ntoma ya Amerika Mike Hammer alobeli lisungi lya USA mpo na kimya na monyele ya RDC	bokengi / securite
Ba Léopards ya RDC baleki na 8es	rdc
Ilunga Ilunkamba atiki mokanda ya bozwi na ye na Cour constitutionnelle	rdc
IGF epesi mikolo 5 na Sénat mpo na kolimbola ndenge misolo misalelamaki wuto 2019 kino 2020	justice
Sylvano Kasongo alimboli likambo ya enlèvement ya député Mbemba	rdc
Evêque Mukuna atiki mokanda ya kofunda Kabila na parquet	justice
TGI Kinshasa/Gombe elobi ekoki kosambisa Kalev Mutondo te	justice
Manu Dibango akufi na COVID-19	rdc
Basango ya le 18 avril 2019 na 16h TU na VOA Lingala	rdc
Bakambi ya ba musulmans bapameli bobomi ya Imam moko na losambo na Beni	bokengi / securite
Tshisekedi azelami na Goma mardi	politiki / politique
Ba Congolais baike balobeli mateya ya bosangisi nzoto epayi na bana	bokolongono / santé / medecine
Fayulu asengi maponami ma lombango, alimbisi mpe asengi kotelemela Malonda (Interview)	politiki / politique
Sassou, Touadera, Deby na Lourenço basengi masolo na Centrafrique	bokengi / securite
Parquet ezali kolukisa Kalev Mutondo	justice
Donald Trump asengi na batomboki kozongela nzela ya Buku likonzi na Mali	bokengi / securite
Pene na bato 36.000 bazalaki na 7ème Festival Amani na Goma	rdc
Bilenge 36 ya Lucha batikami nsima na mposo moko ya bokangami na Goma	rdc
Etats-Unis epesi 50 respirateurs mpo na COVID19 na RDC	bokolongono / santé / medecine
Tshisekedi akosakola mikano na ye o'mokolo mwa eyenga na 14h30 ya Kinshasa	politiki / politique
Bato koleka 30 bakufi mpe koleka 500 bazwami na peste na Ituri	bokolongono / santé / medecine
Sango ya le 13 mai 2019 na VOA Lingala	rdc
Batimoli makele na maboko basengeli kotika mine ya Kove na Lualaba	rdc
Ba ntoma ya bikolo ya bapaya balaki kosunga na kobundisa bozangi bokeni na RDC	bokengi / securite
VOA60 Lingala 23 mars 2021	politiki / politique
Mokambi ya ba FDLR akufi na Allemagne	rdc
MSF ezali koluka basali baye misatu balimwa na 2013	rdc
Société civile esengi bosambisami ya bato bakangami na bibundeli mpe minduki na Beni [TOTALA]	bokengi / securite
Mende akutani na Tshisekedi mpe akomi pene na kokoka Union Sacrée	politiki / politique
Moussa Faki asololi na Tshisekedi mpo kobongisa bokambi na ye ya UA	politiki / politique
"""Cohabitaion to coalition ekozala te na mboka, makambo wana masi maleki,"" ekati Kabund"	politiki / politique
Sous-Sec. adj. Peterson asololi na Fayulu mpo makoki ma bomoto na maponami ma 2023	politiki / politique
Kimya ezongi nsima liwa ya moto na mombongo na ndelo na Ouganda	rdc
Trump alongolaki etumbu ya Dan Gertler yambo atika bokonzi	justice
Kamerhe akozala liboso lya bazuzi le 24 juillet	justice
Baike ya FCC bazalaki te kasi Assemblée nationale endimi mobeko mopesi nzela ya kokota na ZLECAF	politiki / politique
Bato ya boloko ya kala babwaki mbela na Tshisekedi	rdc
Tshisekedi na bokutani na Chambre du commerce USA-Afrique	rdc
Babundi ba Ngumino na ba Twagiraheno nde babomaki koleka bato zomi na Kipupu (mbulatari/Sud-Kivu)	bokengi / securite
VOA60 Lingala 18 décembre 2020	politiki / politique
Sassou asengi droit de veto mpo na Afrika mpe Tshisekedi, lisungi lya molongo na bitumba ya Afrika	politiki / politique
Bayike bapekisi misa mpo na koboya botelemisi mosala ya balakisi na Bukavu	rdc
Ba avocats français ya Kamerhe bazali kobanga mpo na bomoi na ye	justice
Ba Yakutumba, Nyatura, Gumino, Nakiliba mpe Kashumba baboyi cessez-le-feu	rdc
OMS ezali kosala bolukiluki likolo na bofundi ya kozwa basi na makasi na nzela na Ebola	bokolongono / santé / medecine
Bato banei bakufi na mpela na Sud-Kivu	rdc
VOA60 2 juillet 2020	justice
Bakambi ba ECC bazali kokoba koluka kimya na ba matata CACH na FCC	politiki / politique
Ba congolais baike bazali kolata masque te ata mbonge ya mibale ya COVID-19 engali	bokolongono / santé / medecine
Mukwege alobeli bokokani ya basi na babali na likita lya G7	politiki / politique
Ruberwa atindami na mbalakaka na Afrique du Sud mpo na COVID-19	bokolongono / santé / medecine
Koleka 1.500 minduki ya bitumba na ba bombes etiyami maboko na Gbadolite	bokengi / securite
HaltEbola elobeli mosala ezali kosala	rdc
Sassou alaki lisungi na bikolo nzinga nzinga mpo na kimya na mokili	bokengi / securite
Gilbert Kankonde alobi police ekopanza bokutani bwa Congrès mpo na kopekisa COVID19	politiki / politique
Bikolo bya CEEAC bakotinda basoda na Centrafrique mpe bipesi maboko na maponami ma dimanche	bokengi / securite
"""Confinement"" na Brazzaville ntango ya ba feti"	bokolongono / santé / medecine
Motion ya censure mpo na PM Ilunga etikami na Assemblée nationale	politiki / politique
Kabila aboyi PPRD mpe FCC bazala na mbulamatari, elobi Emmanuel Ramazani	politiki / politique
MAPONAMI MA AMERIKA 2020: Matata mabimi likolo na ntango molayi ya kozela koyeba molongi	politiki / politique
Russie ekobanda komeka mangwele ya COVID-19 na juin	bokolongono / santé / medecine
Maponami ya mokambi ya Sankuru lobi le 10 juillet	rdc
Symocel esengi etumbu soki CENI ebimisi bilembo te lolenge esengeli	rdc
VOA60 Lingala 8 mai 2021	bokolongono / santé / medecine
Bato babale bazwami na COVID-19 na Matadi	bokolongono / santé / medecine
Valery Giscard d’Estaing awei na mibu 94	politiki / politique
Kinshasa ekozanga mayi ya komela ntango ya ba feti (Syndicat Régideso)	rdc
Bakeli mibeko 338 balaki kotikala nsima na Kabila na Kingakati	politiki / politique
Minganga misatu ya RDC bakangami mpo na liwa ya moye ya Cameroun na Butembo	rdc
Leila Zerrougui na Tshisekedi basololi nsima na mbela ya Guterres	politiki / politique
Bakambi ya bituka bapesi ndingisa te na botamboli	politiki / politique
Cour ya cassation ekopesa eyano na Kamerhe na 48 heures mpo na bobimisami na ye	justice
Idriss Deby na Tshisekedi bayokani te mpo mboka eye ekozala membre ya Conseil ya sécurité ya ONU	politiki / politique
Balandi ya Kamerhe basengi bobimisami na ye lokolo bato basusu baye batikami	justice
“Sheka” to Ntabo Ntaberi akatelami boloko ya libela mpe batomboki basusu ya NDC mibu	justice
Tshisekedi alaki kosunga balobi mbisi koleyisa bana RDC na Kinkole [TOTALA]	politiki / politique
Moyi Biélorussie Aleksandr Zingman atikami mposo mibale nsima na kokangama na Loano	bokengi / securite
Motango ya babeli ba kintuntu mokiti na Beni	bokolongono / santé / medecine
"""Bandeko bakeli mibeko ba Grand-Kivu, bobima na mangomba ya basima minduki!"" (Prés. Ass. Nat. Mboso)"	bokengi / securite
Ba civiles 6 na ba rangers 12 bakufi na bitumba na parc ya Virunga	bokengi / securite
Baiike na Assemblée nationale basengi botikami ya député Mamba	justice
Tshisekedi azelami na Bruxelles	rdc
Tshisekedi apesi losako ya suka na Lugi Gizenga	politiki / politique
Tshisekedi azongisi boyokani na Belgique	rdc
Moyi RDC Julienne Lusenge kati na basi ba mpiko na molongo [TOTOLA]	politiki / politique
VOA60 Lingala 7 juin 2021	bokengi / securite
VOA60 Lingala 9 avril 2020	justice
Bakata Katanga bakotaki na bibundeli na Lubumbashi	bokengi / securite
Boyokani mpo na mibembo mya mpepo kati Washington na Brazzaville bokoti o’mosala	politiki / politique
Rougeole/Kintuntu ezali koboma koleka Ebola	rdc
"""Bakata Katanga"" bafundami na koboma mokonzi ya ANR na Pweto"	rdc
Mampinga ma Tchad masakolaki ete mabomi batomboki koleka 300 yambo na liwa ya Idriss Deby	bokengi / securite
"Nini koyeba mpo etali ""état de siège"""	bokengi / securite
Ilunga Ilunkamba alobi gouvernement, kala te	rdc
Bintou Keïta asololi na Kabila na Kashamata	politiki / politique
Vital Kamerhe abengisami lisusu mercredi na parquet	justice
Gentiny Ngobila aboyi botamboli ya Lamuka le 30 juin	rdc
VOA60 Lingala 14 mai 2021	politiki / politique
Ibrahim Kabila atindami na parquet	justice
Nsima na etumbu ya liwa na ba musulmans 30, Charles Mbutambutu asengi COMICO koyokona	justice
Bayi Bundu dia Mayalan babale mpe 2 policiers bakufi na bitumba na Kisantu	bokengi / securite
32 mangomba ya basimba minduki bandimi cessez-le-feu na Sud-Kivu	rdc
Mabele maninganaki na etando ya Kivu	bokengi / securite
Mofundami ya misato na liwa ya ba experts ya ONU akufi	rdc
VOA60 Lingala 19 janvier 2021	bokengi / securite
Jeanine Mabunda atikali candidate unique mpo na kokamba Assemblée nationale	rdc
Bato zomi babomami na ba ADF na Kokola, na Beni	rdc
COVID-19: Ba nganda, b'ekala na ba boîtes de nuit ekangami mikolo 15 na mokano ya Tshisekedi	bokolongono / santé / medecine
Ba Congolais batamboli na Washington DC mpo na kopamela bobomi na Minembwe mpe na est (TOTALA)	politiki / politique
Planification familiale to lolenge ya kokabola mabota	bokolongono / santé / medecine
CENCO esengi mbulamatari na MONUSCO kosilisa bitumba na Beni mpe Minembwe	rdc
Mabunda asengi na comité des sages ya Ass. nat. kolandela likambo na kaniaka ya ba députés	politiki / politique
Bakangami 35 bakimi boloko ya Ilebo na Kasaï	bokengi / securite
Nzoto ya nkondo Attanasia ntoma ya Italie ememami na mboka na ye (TOTALA)	bokengi / securite
Mbano ya COVID-19 na ndako ya kopema ya ba mpaka to bakolo	bokolongono / santé / medecine
Minstre Sele Yalaguli afundi SG ya UDPS na Paquet ya Matete, Augustin Kabuya alobi eza maseki	politiki / politique
Bobomami ya Yumbi: HRW esengi bakonzi ya RDC bosembo	rdc
Bemba ayebisi Tshisekedi akopesa ye maboko	politiki / politique
Ministère ya Intérieur ebwakisi Kabund lokola président a.i. ya UDPS	politiki / politique
RDC ezali komilengele mpo na kozongisa ba Congolais bakangami libanda mpo na COVID19	bokolongono / santé / medecine
Sango ya le 1e août 2019 na 16h TU na VOA Lingala	rdc
"Jean-Félix Senga alobi ""Dynamique pour la vérité des urnes"" esengi légitimité etunama na peuple"	politiki / politique
Egypte, Ethiopie na Sudan bazo'luka eyano na Kinshasa na matata ya barrage Renaissance na ebale ya Nil	politiki / politique
FCC epameli boluki majorité mosusu na kosomba ba députés mpe esengi maponami masusu	politiki / politique
VOA60 Lingala 24 novembre 2020	justice
Mokambi ya police ya Kinshasa alobi parquet ewangani ete ebengisi Fayulu na Ngoy	justice
Amerika ezali komema bitumba na kaniaka na RDC na bozindo	politiki / politique
VOA60 Lingala 26 janvier 2021	politiki / politique
"Ne Muanda Nsemi alobi akomi ""président"" ya mboka"	rdc
Bosco Ntaganda azwi etumbu ya mibu 30 na boloko	rdc
Eteni Longondo akanisi kino le 17 novembre RDC ekokisala Ebola esili na Equateur (TOTATLA)	bokolongono / santé / medecine
Ba Bareas bakweyisi ba Leopards na 8e de finales	rdc
Couvre-feu elongwe na bituka bizali na COVID-19 mingi te mpe ekomi 22h-4h na Kinshasa	bokolongono / santé / medecine
Sango ya le 18 juillet na 16h TU na VOA Lingala	rdc
Gims ayanoli na VOA Lingala yambo na concert na ye na stade de France	rdc
Bokomi ya Moïse Katumbi na Goma (Bilili)	rdc
CENCO ekutanaki na Fayulu (TOTALA)	politiki / politique
Ba candidats balongolami na maponami ya Bureau définitif ya Assemblée nationale batomboki (Gatrien Iracan)	politiki / politique
"Ba FDLR bapameli ""boyokani ya nkuku"" kati na Tshisekedi na Kagame"	rdc
"TOTALA : Lisikulu ya Tshisekedi kosala ""état de siège"" mpo na Nord-Kivu na Sud"	politiki / politique
PM Sama Lukonde alaki ete bokengi nde moko na makambo ma liboso	politiki / politique
VOA60 Lingala 1er janvier 2020	politiki / politique
VOA60 Lingala 14 mars 2020	rdc
Bakambi ba bituka na ndelo kati na RDC na Angola bayokani kotia bisika ya mobongo	politiki / politique
Kagame, Sassou, Lourenço na Touadera basengi ete bato bazali kosala mobulu na RCA batindama na bazuzi	bokengi / securite
Sama Lukonde akutani na Tshisekedi mpe alaki botiami ya mbulamatari kali mingi te	politiki / politique
Ensemble esengi botosi ya Code minier mpo etali bokengi	rdc
Matanga mpo na Idriss Deby na Congo-Brazzaville mpe na RDC vendredi	politiki / politique
General Electric ya USA eyokani na mbulamatari mpo na ba projets ya pene 1,8 milliards $	rdc
PGR Kabange asengi etumbu mpo na kopesa baponi biloko ntango na maponami	rdc
VOA60 Lingala ya le 21 février 2020 (Totala)	rdc
"Tshisekedi na Macron basololi mpo na bokutani bwa ""One Planet"" mpe Centrafrique"	politiki / politique
Cour ya cassation eboyi kobimisa Kamerhe	justice
Ndenge bato batambolaki mpo na koboya Malond	politiki / politique
Sango ya le 14 mai 2019 na VOA Lingala	rdc
Dr. Eteni Longondo alimboli soki RDC ekomi wapi na COVID-19 [TOTALA]	bokolongono / santé / medecine
Tshisekedi asoli na bakambi ya mampinga, bokengi mpe migration mpo na est	rdc
MLC esengi mbulamatari kozwa mokumba ya bokengi na est	politiki / politique
VOA60 Lingala 17 novembre 2020	politiki / politique
Volcan Nyiragongo: Bavandi mingi ya Goma batiki engumba	bokengi / securite
72% ya bana balongi na Exetat na Kinshasa	rdc
VOA60 Lingala 15 juillet 2020	justice
Bokutani ya Tshisekedi na Pompeo na Washington (Vidéo)	rdc
Moto ya misato azwami na Ebola na Mwenga mpe ya yambo na Walikale	rdc
Tango Four atangami na boteki zamba na kobukaka mobeko	rdc
"ACAJ epameli projet ya ""Secrétariat ya ba présidents élus"" ya kala"	politiki / politique
PM Ilunga apameli VPM Kankonde mpo na likambo ya Matubuana	rdc
Jean-Michel Sama Lukonde Ministre wa yambo ya sika nde nani? [TOTALA]	politiki / politique
Examen d'Etat ebandi na Beni	rdc
"Mokambi ya ba ""Maï Maï Jackson"" afundama na koboma ba éco-gardes 19 akangami"	bokengi / securite
Koleka bato 2.000 bakufaki na bitumba na Ituri na 2020 mpe 6.000 na Beni wuto 2013 (CENCO)	politiki / politique
Milulu mya kondima elonga ya Biden mikatami mpo na eyoma ya balandi ba Trump na Congrès	politiki / politique
Etienne Tshisekedi, Héros national, Lucha esengi débat na parlement	rdc
"""Na Bozindo!"" Nationalité RD Congolaise: ""Exclusive to Irrëvocable?"""	bokengi / securite
Tshisekedi asengi bana ba Tchad babungisa te makasi Idriss Deby asalaki mpo ekolo ezala na bomoko	politiki / politique
Directeur administratif ya Maison civile ya Tshisekedi abwakami na Makala mpo na bato ba yawuli	bokengi / securite
Tshisekedi akani kotelemisa botiami ya Minembwe bo' commune (Vidéo)	politiki / politique
Moto ya yambo azwami na COVID-19 na Goma	bokolongono / santé / medecine
VOALingala 11 mai 2021	bokengi / securite
Franck Diongo alobi etumba ya kotelemela mbongwana ya Constituion nde mobandi	rdc
VOA60 lingala 9 avril 2021	politiki / politique
SADC endimi kokoba kopesa maboko na bitumba ya RDC	politiki / politique
Eyoma ya balandi ya Trump na milulu mya Congrès mpo na kondima elonga ya Biden	politiki / politique
VOA60 1er octobre 2020	justice
Molongi azwami nanu te kasi Biden azali se komata na Maponami ma mokonzi ya USA	politiki / politique
Na Bonzido! Ba mama baike ya USA basengi botiami na mosala ya rapport mamping ya ONU	justice
Bato 23 bazwami na Ebola na mikolo minei	rdc
Tshisekedi asakoli état de siège mpo na Nord-Kivu mpe na Ituri	bokengi / securite
VOA60 Lingala 17 avril 2021	politiki / politique
Bemba atikeli Muzito bokambi ya Lamuka	rdc
VOA60 Lingala 16 avril 2020	bokolongono / santé / medecine
Bana ya zuzi Yanyi basengi bosembo na liwa ya tata na bango	justice
Sassou andimami mpo na kopesa nkombo na présidentielle na ngambo ya majorité	politiki / politique
VOA60 Lingala 26 février 2021	politiki / politique
Sénateur Lola Kasanga awei nsima na ntango moke ya bokono	politiki / politique
DG ya OVD na ya SOCOC babimi boloko	justice
VOA Lingala 24 août 2020	politiki / politique
VOA60 Lingala 2 avril 2021	bokengi / securite
Washington Forum: Misala mizali kozela Tshisekedi na bokambi Union africaine	politiki / politique
VOA60 Lingala 2 janvier 2020	bokolongono / santé / medecine
PM Ilunga aboyi kozwa nyongo ya Banque centrale kasi akosalela bons du trésor	rdc
Ebola ezongi lisusu na Equateur	bokolongono / santé / medecine
Etude moko elobi hydroxychloroquine mpe chloroquine ezobikisa COVID19 te (Lancet)	bokolongono / santé / medecine
Député provincial Mike Mukebayi abimi boloko na Kinshasa	justice
Tshisekedi asakoli Etat d’urgence na RDC mpo na COVID-19	rdc
VOA60 Lingala 8 juin 2021	politiki / politique
VOA60 Lingala 7 mai 2021	bokengi / securite
FARDC elaki kobatela makoki ma bato kasi ekebisi baye bokotelemela yango na état d'urgence	bokengi / securite
COVID-19: Mokambi ya Task Force na RDC ayanoli na VOA Lingala	bokolongono / santé / medecine
VOA60 Lingala 12 juin 2020	justice
Biden azali kolonga na Georgia mpe Pennsylavania, ba états etikali lokola libaku lya suka ya Trump	politiki / politique
Basi batambolaki mpe basalaki matanga mpo na kosenga bokengi na Beni {TOTALA}	bokengi / securite
VOA60 Lingala 27 janvier 2021	politiki / politique
Ba banyamulenge batelemeli bobomani na bango	rdc
VOA60 Lingala 2 mai 2020	bokolongono / santé / medecine
Gombe ekangami	rdc
VOA60 Lingala 27 mai 2020	politiki / politique
Pene na bato mwambe bakufi na bokangami ya Ne Muanda Nsemi (Min. Intérieur)	bokengi / securite
Eyano ya Daniel Safu nsima na bozongisami na ye lokola député	rdc
"Police ya Kinshasa elobi ezuwi baye bakanga basi na taxi ""Ketch"""	rdc
Bondogwani ya matata kati na Trump na Biden	politiki / politique
VOA60 Lingala 10 mars 2020	rdc
VOA60 Lingala 28 mai 2021	bokengi / securite
Ba députés 305 ya FCC bakebisi kofunda na bazuzi baye balingi kosomba boko kati na bango	politiki / politique
Ville ya Beni na kati ya quarantaine	bokolongono / santé / medecine
Tshibala a suspendre ministre ya Affaires foncières	rdc
FARDC elobi ebomi ba ADF 22 mpe ekangi koleka 60 wuto état de siège ebanda na est ya mboka	bokengi / securite
VOA60 Lingala 5 janvier 2021	justice
VOA60 Lingala 13 janvier 2021	politiki / politique
CACH na FCC balobi Fayulu atika distraction	rdc
Idriss Deby akufi na masasi na mibu 68	politiki / politique
Ministre ya Défense ya RDC na ambassadeur ya Etats-Unis basololi mpo na formation ya FARDC na USA	bokengi / securite
VOA60 Lingala 8 janvier 2021	politiki / politique
Bato 210 babomaki na janvier na Est, kolanda KST	rdc
Police epanzaki botelemeli mpo kosenga bolengwi ya ntoma ya Rwanda na Kinshasa	politiki / politique
Biden alaki kosala na Union africaine ntango Tshisekedi azo'zwa bokambi na yango	politiki / politique
Bokolongo mpe bomoi : Syrose de foi	bokolongono / santé / medecine
Bosambisami bwa Kamerhe: Cour d'appel esangami kozela Cour ya cassation (Michel Moto)	justice
Ebola etikali urgence internationale mpo na sanza misatu	rdc
Lisikulu ya Katumbi na bokutani ya Ensemble na Lubumbashi (na Lingala)	rdc
VOA60 Lingala 9 juillet 2020	politiki / politique
Biteni ya mpepo moko bimonani na Kole, na Sankuru	rdc
Astronaute Robert Curbeam akaboli boyebi na ye na bilenge ya RDC	rdc
Nzoto ya nkondo Etienne Tshisekedi ekomi na Kinshasa	rdc
Mokanda ya Trump na Tshisekedi mpo na mibu 60 ya lipanda ya RDC	politiki / politique
Prefecture ya Brazzaville epekisaki botamboli mpo na kosenga bobimisami ya Mokoko na boloko	politiki / politique
PM Ilunga asengi na CACH na FCC babongisa ba listes na bango	rdc
"""Linu lya Lumumba"" likozongisama lisusu te le 21 juin na RDC"	politiki / politique
Moto moko akufi, tribunal mpe bureaux etumbami na mobulu ya bayi UDPS na Kasumbalesa	bokengi / securite
Procureur ya Matete atindi bolukiluki na esika nkunda ya bato ebele emonani na N'Sele (Kapiamba)	justice
Ba FARDC bakokolisa boyokani na mboka nzinga nzinga mpo na kobundisa ba ADF, FDLR mpe basusu	bokengi / securite
Trump apameli OMS mpo na kokamba malamu te bitumba na COVID-19	bokolongono / santé / medecine
Ntoma Châtaigner alobi UE ekokota makambo ya kati ya RDC kasi elingi boyokani (TOTALA)	politiki / politique
Lamuka epesi maboko na mbela ya botamboli ya ba mouvements citoyens le 19 juillet	politiki / politique
"""Plus l'état de siège durera de moins en moins la population l'acceptera"", prévient Fred Bauma/GEC"	bokengi / securite
Episkopo moko ya RDC abetami na bapaya bazali kosenga kolongwa na Afrique du Sud	rdc
"Fayulu : ""Union sacrée ezali kaka zemi ya mibale ya libala FCC-CACH"" [TOTALA]"	politiki / politique
FCC elobi CACH ebima na mbulamatari mpe elaki kokende na bazuzi [TOTALA]	politiki / politique
J-P Bemba alobeli mosala MLC esala mpo Congo ekoma esika ezali lelo	rdc
Mbulamatari asali boyokani ya kimya na FRPI na Ituri	rdc
Congo-Brazzaville esombaki 500 tonnes ya minduki na Azerbaidjan wuto 2015	bokengi / securite
Nzoto ya bawei 18 etiami o’lilita nsima na likama lya mine ya Kituga	bokengi / securite
Tshisekedi, Macron na bakonzi basusu ba Afrika basengi mangwele ma COVID-19 kosalamaka na Afrika	bokolongono / santé / medecine
Ba FARDC balakisi 36 ADF bakangi na Beni	rdc
Ibenge na Mulumbu balobi esengeli kozwa Madagascar na bokengi	rdc
Amnesty International epaleli Tshisekedi na kowangana bilaka ya kopesa bosembo na ba victimes ya bokonxi ya Kabila	justice
VOALingala 120 26 juin 2020	politiki / politique
Ba ADF babomi lisusu kolekabato 22 na Territoire ya Beni	bokengi / securite
FCC elobi esali oyo ekoki mpo bilongi ya sika bikota na gouvernement	rdc
VOA60 Lingala 19 août 2020	bokengi / securite
VOA60 Lingala 1er avril 2021	politiki / politique
Bitumba kati na Assemblée nationale [TOTALA]	politiki / politique
Misolo mya COVID19 mipengwasami, elobi vice-ministre ya bokolongono	bokolongono / santé / medecine
Fayulu asengi Tshisekedi koboma libala na Kabila	rdc
Kengo wa Dondo abimi na hôpital na Bruxelles	rdc
Nzala na boloko ya Makala: wuto mikolo minei bilei mpe mino bipesami te	justice
Fayulu azwi boyangeli bwa Lamuka	politiki / politique
VOA60 Lingala 25 février 2021	bokengi / securite
HRW esengi enketi mpe epameli mampinga na kotelemela batamboli	politiki / politique
SG ai ya UDPS Agustin alobi bato basto bakufi na botamboli na Kinshasa	politiki / politique
VOA60 Lingala 11 juillet 2020	justice
VOA60 Lingala 4 mai 2021	bokolongono / santé / medecine
VOA60 Lingala 26 février 2020	rdc
Marche ya CLC ekomi lundi mpo na Kinshasa	rdc
Botamboli ya FCC: Mwilanya alobi ba ordonnances ya mokonzi mboka elakisi bobuki Buku likonzi	politiki / politique
Trump alongoli mokambi ya Pentangone (ministre ya Bobateli ekolo)	politiki / politique
VOA60 Lingala 14 septembre 2020	bokengi / securite
Leader nani azali kosunga bandeko komibatela na COVID-19?	bokolongono / santé / medecine
VOA60 Lingala 9 juin 2020	politiki / politique
Basango ya le 20 mars 2019 na 14h TU na VOA Lingala	rdc
Ntoma ya Italie akufi na masasi na Goma mpe mbulamatari ya RDC elaki kokanga babomi	bokengi / securite
Peter Kazadi ayebisi ntina nini ministre Guy Matondo atindami na bazuzi	rdc
Lisikulu lya Félix Tshisekedi na 75e Assemblée générale de l’ONU UNGA	politiki / politique
Katumbi alongi bosambisami mpo na kozongela misala ya mines na MCK	rdc
VOA60 Lingala 17 février 2021	bokolongono / santé / medecine
Etat de siège: Ba FARDC bakangi “grand colonel” Nshimiyimana moko na bakambi ba FDLR	bokengi / securite
Likama lya bokwei ya ndako na Lubumbashi (Bililingi)	bokengi / securite
Mobulu na zando ya Kinshasa	bokengi / securite
Bitumba ya Tshisekedi na Kabila bingali libanda lya mboka	politiki / politique
Mazembe enyefoli Zesco 3-1 mpe esilisi yambo na groupe A ya Ligue des champions	rdc
Ministre ya sika ya Bokolongo Dr. Mbungani alaki kobongola mayele ya bokobundisa makono na RDC	bokolongono / santé / medecine
B’échantillons ya Lubumbashi ezali COVID-19 te	rdc
Moto wa yambo na COVID19 : Lubumbashi na Kasumbalesa ekongama	bokolongono / santé / medecine
Bolukiluki bozali kokoba nsima na bozindi ya baleinière na Maï-Ndombe	rdc
VOA60 Lingala 26 octobre 2020	politiki / politique
Tshisekedi akutani na nkumu Philippe na PM Charles Michel na Bruxelles	rdc
Bakeli mibeko bakolekisa na boponami mokano ya kokweyisa Trump	politiki / politique
VOA60 Lingala 8 septembre 2020	justice
Batomboki 222 bamizongisi na bakonzi na Masisi	rdc
Bazuzi bakoti kinzonzi nsima na Kamerhe, Jamal mpe Muhima koloba bazali ba innoncents	justice
VOA60 Lingala 9 juin 2021	bokengi / securite
avid Blattner abandaki kosamba na TGI/Gombe	justice
MLC ebengi bato kotambola samedi nsima na invalidation ya ba parlementaires ya opposition	rdc
Museveni, candidat ya maponami ya 2021 na Ouganda	politiki / politique
"Etat de siège ""Eyano esengeli esangisa misala mya ba soda na makambo masusu mpo na kimya ekowumela"", Fred Bauma ya GEC"	bokengi / securite
VOA60 20 avril 2021	bokengi / securite
VOA60 Lingala 10 mai 2021	justice
Kagame alobi ata soda moko te ya Rwanda aza na RDC	bokengi / securite
Sous-secrétaire adjointe Peterson azali na Kinshasa na masolo mpo na maponami ma 2023 na RDC	politiki / politique
VOA60 Lingala 28 mai 2020	justice
Bemba andimi mabongisi ma mobeko mpo na mbongwana ya maponami ya lingomba ya ba 13	politiki / politique
BCNUDH esengi bolukiluki na ndenge police ezokisaki batu ba botamboli na Buakvu	bokengi / securite
CACH na FCC bazalaki te na Forum mpo na boyakani na ntina ya mbongwana na maponami	politiki / politique
Katumbi aboyaki bato batambola nsima na nzoto misato ya baye batambolaki na UDPS elokotamaki na ebale	politiki / politique
Major Christian Ngoyi oyo atangama na liwa lya Chebeya akangami na Lubumbashi, atandami Kinshasa	justice
Bazuzi basato ba Cour constitutionnelle balapi ndayi o'boso bwa Félix Tshisekedi (TOTALA)	politiki / politique
Tshisekedi alobi ya motuya nde kimya na bikolo nzinga nzinga mpe bosembo bokolandama	politiki / politique
Tshisekedi atie matanga vendredi mpo na Idriss Deby	politiki / politique
Ba 13 basengi na bakonzi kotala na lombango mabongisi mpo ma maponami masala na ntango	politiki / politique
Koleka bato sambo bakufi na mikolo mibale na bitumba kati na bakuba na baluba na Kasaï	bokengi / securite
Ba FDLR nde babomi ntoma Attanasio ya Italie na Kimbunda, elobi ministère ya Intérieur	bokengi / securite
Ngoyi Mulunda akosamba na mbalakaka na Kasapa kasi mobulu mobimaki na Lubumbashi	bokengi / securite
Ba sénateurs ya RDC basengi Amerika ekotaka te na makambo ya bana ya mboka	politiki / politique
Mokambi ya diaspora ya Rwanda abomami na masasi na Mozambique	rdc
Corée du Nord elekaki na nzela ya ba banques ya RDC mpo kokota na système financier mondial (Sentry)	bokengi / securite
Herman Cain candidat ya moyindo ya ba républicains na présidentielle ya 2012 akufi	bokolongono / santé / medecine
Katumbi azwi palata ya mokambi ya malamu koleka na CAF Awards	rdc
VOA60 Lingala 29 avril 2020	bokolongono / santé / medecine
Bokutani ya Lamuka epusani o’mokolo ya eyenga	rdc
VOA Lingala 27 août 2020	justice
Moto ya mibale amonani na Ebola na Uganda	rdc
Balandi ba Kamerhe basali makelele na Palais ya Justice mpo na kosenga bobimisami bwa ye	justice
Mwasi moko ya Québec azosambisama mpo atindelaki mokanda na poison na Trump	bokengi / securite
Bayi Amerika bazwi mangwele bapesami ndingisa ya kotambola na bozangi masque	bokolongono / santé / medecine
Etat islamique endimi mbala ya yambo attack na RDC	rdc
Bato 7 bawei na bitumba kati na basima minduki na bakengeli parc ya Virunga	rdc
Matata Ponyo na Bruno Tshibala bazalaki te na bokutani ya ba PM ya kala Tshisekedi	politiki / politique
Samy Badibanga atiki mosala ya 1er VP ya Sénat	politiki / politique
Kamerhe azalaki te na bosambisami bwa ye vendredi, audiance ekoya etiami nsima na mposo mibale	justice
VOA60 Lingala 11 décembre 2020	politiki / politique
Bato ya Ngudjolo bakimisi basimba minduki 350 ya CODECO na camp ya transit	rdc
Tshisekedi alobi andimi kokufa mpo na kimya na mboka	rdc
Jean-Jacques Mamba asikolami	justice
Me Liyolo akufi	rdc
Mokambi ya APLC atiami na bokangami	justice
Tshisekedi abimisi mbulamatari ya Sama	politiki / politique
Maponami ma 1er vp ya Assemblée nat. masalemi lisusu te mpo police ekangi nzela	justice
Bato batamboli bisika mingi mpo na kotelemela kaniaka	rdc
Mokambi ya Assemblée provinciale akweyisami na Haut-Katanga	politiki / politique
VOA60 Lingala 9 septembre 2020	politiki / politique
Tshisekedi aboyi likita lya mbulamatari mpe alaki kozwa maloba liboso lya Ekolo vendredi	politiki / politique
Commissaire div. adj. Kasongo akebisi bato bakota te malako ya kopekisa COVID	bokolongono / santé / medecine
Sango ya le 5 juillet 2019 na 16 h TU na VOA Lingala	rdc
VOA60 Lingala 4 août 2020	bokengi / securite
Sassou, Kagame, Lourenço na Touadera basengi Bozise ba batombi kotika bitumba na Centrafrique	bokengi / securite
VOA60 Lingala 29 mars 2021	politiki / politique
Kimbembe Mazunga na Laya Sinsu batiami na Makala	justice
VOA60 Lingala 6 mars 2021	politiki / politique
"CENCO, ECC, G13 na basusu bapameli Parlement na koboya ko ""dépolitisier"" CENI"	politiki / politique
Tshisekedi, Bemba na Katumbi basololi mpo na mbulamatari mpe Fayulu alaki koloba le 30 décembre	politiki / politique
Parquet TGI Gombe esengi autopsie mpo ya nzoto ya zuzi Yanyi	justice
Basimba minduki bazwi engumba Bambari na Centrafrique	bokengi / securite
John Numbi na ba officiers basusu koleka 80 ya Lubumbashi bapesami mitindo ya kokende Kinshasa	bokengi / securite
Ntoma ya Amerika asololi mpo na kimya na kabila ezali na matata na ba Hauts plateaux	bokengi / securite
Mokoni suka ya Ebola (2e vague) abimi na CTE na Beni	bokolongono / santé / medecine
Bemba, Fayulu, Katumbi na Muzito babengisi botamboli le 13 juillet mpo na kotelemela Malonda	politiki / politique
"Ambassadeur ya USA ""Nzita"" ""Amani"" Mike Hummer"	rdc
Police elobi ezwi minduki na campus ya Unikin	rdc
Basimba minduki mpe mampinga babomi 197 civils na décembre na Est	rdc
VOA60 Lingala 18 novembre 2020	politiki / politique
Kabila na Peter Pham babeti masolo ya boyokani ya sika na Etats-Unis	rdc
Mokambi ya Sankuru ya sika J. Mukumadi akoti CACH	rdc
Ambiance na Kinshasa yambo bokomi ya nkondo Tshisekedi	rdc
450 Congolais ya Kinshasa mpe Brazzaville bakoti nzela ya makolo na USA	rdc
Ilunga Ilunkamba alimboli na Ass. Nat. ndenge nini akosalela 132.2 millions $ ya COVID19	bokolongono / santé / medecine
CENI ezongisi candidature ya Mukumadi mpo na maponami na Sanukuru	rdc
Basoda ya Brésil basungi ba FARDC na mateya mpo na kobundisa ba ADF	rdc
VOA60 Lingala 02 février 2021	politiki / politique
Ass. Nat. : Jaynet Kabila alongwe na bokambi Commission Défense mpe Coopération mpe Mubonzi azwi esika	bokengi / securite
Babanyamulenge baboyi masolo kasi basengi gouvernement eyano na Minembwe	rdc
Ministre ya Bokolongo asakoli suka ya Ebola na est	bokolongono / santé / medecine
Etats-Unis ebakisi 23,4 millions $ ya lisungi mpo na bitumba na Ebola	bokolongono / santé / medecine
Pierre Buyoya mokonzi ya kala ya Burundi akufi na COVID-19	politiki / politique
Lucha epesi mbano na ba sango mpo mpiko na bango	rdc
Ruberwa alobi akendaki te na Minembwe kotia bourgmestre kasi mpo na bokengi mpe kimya	bokengi / securite
VOA60 Lingala 31 août 2020	politiki / politique
Elombe ya bibotu na molongo Ilunga Makabu alongi Papin ya Russie	rdc
Ministre wa yambo ya Côte d’Ivoire Amadou Gon Coulibaly akufi	bokolongono / santé / medecine
Sassou na matanga ya mokambi ya kala Ass. Nat. ya Gabon na Libreville	politiki / politique
Maponami ma USA 2020: Trump-Biden nani azali kolonga? [TOTALA]	politiki / politique
VOALingala 3 avril 2021	bokengi / securite
Goma ebiki na botomboki ya volcan Nyirango kasi batu 15 bakufi mpe mboka 17 mizikisami	bokengi / securite
Mbulamatari epekisi botamboli bonso mpe esenge FCC na CACH kobanda masolo	politiki / politique
Tunda atiki mosala (Vidéo)	politiki / politique
VOA60 Lingala 28 02 2020	rdc
Bitumba na Assemblée nationale mpo na nkasa ya bosengi bolongwi ya Kabund	politiki / politique
VOA60 Lingala 25 mai 2020	justice
Bato basololi V-P Mike Pence mpo na alati masque te pene na bakoni ya COVID19	bokolongono / santé / medecine
Bureau ya commune, police mpe ndako esusu ezikisami na mobulu na Kalima (Maniema)	rdc
Sango ya le 21 juin 2019 na 16h TU na VOA Lingala	rdc
Sango ya le 14 juin 2019 na VOA Lingala	rdc
Lisolo ya mosolo ya libota ya Kabila moye mobombana	rdc
FARDC ezongisi ngombe 62 na Banyamulenge na Uvira	rdc
Bobomi na bozangi bosambisi bokiti na 9%, kolanda ONU	rdc
Bakeli mibeko 338 balaki kotikala nsima na Kabila na Kingakati [TOTALA]	politiki / politique
Trump alobi mikolo mikoya mikolakisa nani alongaki	politiki / politique
VOA60 Lingala 11 septembre 2020	justice
Tshisekedi asengi bolukiluki mpo na liwa ya général Kahimbi	rdc
VOA60 Lingala 15 mai 2021	justice
VOA60 Lingala 12 janvier 2021	politiki / politique
VOA60 Lingala 30 mars 2021	bokengi / securite
Mokeli mibeku Munubo asengi ministre ya Bobateli kolimbola mpo na basoda ya Rwanda na RDC	bokengi / securite
Ba avocats basengi bolukisami ya Kalev Mutondo bosukisama	bokengi / securite
Volcan Nyiragongo: Chérubin Okende alimboli mpo na nini akangi ba aéroports ya Goma na ya Kavumu	bokengi / securite
Jeanine Mabunda amemi maloba mya elikya na Bunia	rdc
Tshisekedi na Museveni bandimi kotonga pene na 1.200 kms ya nzela na mibu mibale	rdc
Basimba minduki babomi basoda babale, policier moko na civil moko na Ituri	rdc
Volcan Nyiragongo: Bavandi ya Goma basengami kotima ba quartiers baike	bokengi / securite
Bapaya ba mombongo mpe tourisme ya bikolo 15 esengeli basimbisa $15.000 yambo na koya na Amerika	politiki / politique
Tshisekedi akutani na Mukwege na New York mpe alaki kopesa ye mbano	rdc
VOA60 Lingala 19 mars 2021	bokolongono / santé / medecine
Goitre to lingundu lya kingo	bokolongono / santé / medecine
VOA60 Lingala 24 juillet 2020	justice
Bitumba bingalaki kati na ba Banyamulenge na ba Maï Maï ya ba Bembe, Nyundu na Fulero	bokengi / securite
Tshisekedi alaki kotiya alima na misala ya Energie mpo na kobenda ba investisseurs	rdc
Totala ndenge Kamerhe, Jamal na Muhima baketelami etumbu	justice
Dr. Muyembe na ba ntoma ya Amerika na Canada bazali ba Mbandaka bisika ya Ebola	bokolongono / santé / medecine
USA, Canada, Royaume-Uni na Suisse bapaleli botelemeli Monusco	rdc
Monusco ekokanga ba bureaux mpe antennes biyike mpo na mbongo ekiti	rdc
VOA60 Lingala 26 septembre 2020	bokengi / securite
Pierre Lumbi secrétaire général ya Ensemble akufi	politiki / politique
Basango ya le 26 mars 2019 na 16h TU na VOA Lingala	rdc
Cour constitutionnelle ezongisi Jean Bamanisa gouverneur ya Ituri	rdc
Mobulu na Paris nzinganzinga ya concert ya Fally Ipupa (vidéo)	rdc
Fayulu na Muzito basengi CENI elongwa na nse ya mpifo ya bayi politiki	politiki / politique
Ba ADF babomi lisusu bato 20 na Beni	rdc
Préliminaire ya Examen d’Etat esalami te na Beni	rdc
Sama lukonde na Ilunga Ilunkamba bakutani mpo na kobongisa bopesani bokonzi	politiki / politique
Cour const. esengi dossier ya bosambisami ya Kemerhe, Jamal na Muhima	justice
Milulu ya Banyamulenge na USA mpo na kosenga bobomi bango bosila [TOTOLA]	bokengi / securite
Sassou alongi maponami na 88,57%	politiki / politique
VOA60 Lingala 23 janvier 2021	politiki / politique
Mokambi ya ba Kamwina Nsapu Laurent Nsumbu aketelami boloko ya libela na Kananga	justice
Masanga ya Lamuka masengi mbongwana ya Cour constitutionnelle	rdc
Assemblée provinciale ya Kongo central eboyi ete balandela mokambi ya etuka	rdc
VOA60 Lingala 21 mai 2021	bokolongono / santé / medecine
VOA60 Lingala 14 juillet 2020	politiki / politique
VOA60 Lingala 11 février 2021	politiki / politique
Kabund ayanoli na maloba ma Kagame ete botiami ya TPIRDC nde ekosukisa makambo	bokengi / securite
Bilili ya bokomi ya Kabila na Sénat	politiki / politique
Ngoyi Mulunda akatelemi mibu misato mya boloko kasi ba avocats bazalaki te [TOTALA]	justice
VOA60 Lingala 13 juin 2020	justice
Tshisekedi azwi bilembo bya mokambi ya Union Africaine	politiki / politique
VOA60 Lingala 22 octobre 2020	justice
Cour suprême ya Etats-Unis etiki nzela ete Kalev Mutond na Thambwe Mwamba bakoka kosambisama	justice
Basi 500 babika na Ebola basungami na ONU-Femme na Bikoro (Equateur)	rdc
Sassou asengi bomoko, bondeko na kimya na botombeli mobu molamu na ba corps constitués	politiki / politique
Président Tshisekedi (RDC) na PM Clément Mouamba (Congo-B.) na bokutani ya Amazonie	rdc
Misala mya sembo ya France misakoli ete nzoto ya Kolelas elakisi ete akufaki na COVID-19	politiki / politique
Mbela ya cardinal FrAmbongo mpo na nzela ya Kimwenza na Kinshasa	politiki / politique
Bawei na bomati mayi na Uvira bakomi 52	bokengi / securite
Volcan Nyiragongo: Pototo ya moto etelemi pene na Goma nsima na kozikisi ndako mpe biloko mingi	bokengi / securite
Mende atikami nsima ya bokangemi mwa ntango	rdc
Sama Lukonde alobeli makambo ma motuya akosala [Totala]	politiki / politique
Jaynet Kabila akomba commission bobateli mpe bokengi na Ass. nat.	rdc
Katumbi, Fayulu, Muzito na Bazaiba na masolo Lamuka	rdc
Tshisekedi, bikolo bya Union na Macron basololi mpo na bopesi mangwele ma COVID-19 na Afrika	bokolongono / santé / medecine
VOA60 28 août 2020	bokengi / securite
Albert Yuma aponami lisusu mpo na kokoba kokamba FEC	politiki / politique
Misala mya makoki ma bomoto mya ONU mipameli maloba ya UDPS ya kokanela basusu	politiki / politique
VOA60 Lingala 15 décembre 2020	politiki / politique
Kagame alobi rapport mapping ekelama na bapaya ba Afrika mpo na kapakola Rwanda	bokengi / securite
Burundi: Buyoya aboyi kondima etumbu ya boloko ya libela akatelami na liwa lya Ndandaye	justice
Fayulu alobi mbongwana ekowuta kaka libanda na ba institutions ebima na maponami ya mabe [TOTALA]	politiki / politique
VOA60 Lingala 23 juin 2020	justice
VOA60 Lingala 27 avril 2021	politiki / politique
Bolukiluki bozali kokoba nsima na nzoto 60 kozwama na likama lya balenière pene na Maluku (Mbikayi)	bokengi / securite
Moto moko akufi na Ebola na Biena (Butembo)	bokolongono / santé / medecine
VOA60 Lingala 3 juin 2020	bokolongono / santé / medecine
Bavandi ya Goma bakangi ADF moko na ba bombes artisanales	rdc
Héritier Watanabe akoki kozwa etumbu ya mibu zomi (Me Kapiamba)	rdc
FCC ezali na ntina ya kolukela Tshisekedi mabe te, eyebisi Atundu	rdc
Tshisekedi aniati makolo na Kigali	rdc
VOA60 Lingala 17 août 2020	politiki / politique
Tshisekedi akeli Lumumbaville na bokanisi mibu 60 ya Lipanda	politiki / politique
"""Automédication"" to komela nkisi yo moko mpe mbano na yango [TALA Reportage]"	bokolongono / santé / medecine
Auditeur général ya Haute cour militaire atindi bolukisami ya John Numbi	justice
Secrétaire d’Etat ya Amerika mpo na bokolongono azelami na Kinshasa	rdc
Moto ya mibale amonanaki na Ebola na Goma akufi	rdc
VOA60 Lingala 23 novembre 2020	politiki / politique
Sassou atie Collinet Makosso bo’ Ministre wa Yambo	politiki / politique
Washington elobi ekosunga RDC na 600 millions $	rdc
Bato babandi kolota ba masque nsima na moto moko kozwa na coronvirus na Kinshasa	rdc
Liwa lya Rossy Mukendi: Commissaire Sup. Adj, Lokeso atindami na Cour militaire	justice
Faure Gnassingbé na masolo na Sassou na Oyo	politiki / politique
Pene na 10.000 bakimi bitumba ya Soudan du Sud bakomi na Aru	rdc
Nkisi ebikisi babeli ya Ebola na Est	rdc
UDPS esengi bakanga bato bazalaki kozwa mpako na post Bilanga na Kasumbalesa	bokengi / securite
Mbulamatari ya Biden ezali kotia loboko' ya sika na boyokani na Tshisekedi, elobi ntoma Booth	politiki / politique
VOA60 26 avril 2021	politiki / politique
Bopona : Nani azo’ sala makambu ya malamu ntango eye ya COVID-19?	bokolongono / santé / medecine
Ilunga asengi bomoko mpe alaki kozongisa nzoto ya Mobutu na Tshombe	rdc
UE ebakisi mikolo na etumbu ya Shadari, Kalev, Amisi, Numbi na bato basusu sambo	politiki / politique
Fayulu atuni soki mboka ezali kokende mpo ebebi koleka [TOTALA]	politiki / politique
"""Toz'ozela bikamwa na mbulamatari ya Sama,"" elobi Ferdinand Kambere"	politiki / politique
Sénat ebwakisi bosenga ya kolongola immunité to bobateli ya Matata Ponyo	justice
Dr. Mukwege apameli Banyamulenge na koboma bato mingi na Kipupu na Sud-Kivu	bokengi / securite
Sango ya le 15 juillet 2019 na VOA Lingala	rdc
Bato 6 bazoki makasi ntango bakangami bamekaki kokima na boloko bonene ya Kasapa na Lubumbashi	bokengi / securite
Lamuka esengi bolukiluki  mpo na 15 millions $, kaniaka mpe mbeba inso ya mikolo miye	rdc
VOA60 Lingala 9 octobre 2020	bokengi / securite
RCD/KML eyebisi ntina nini Mbusa atiki Lamuka	rdc
VOA60 Lingala 3 mars 2020	rdc
"Mbano ya (""confinement"") bovandisami na ndako na bosangisi nzoto ya bazalani"	bokolongono / santé / medecine
Misala mya bosembo ya Belgique mipesi ndingisa ya kozongisa miye mitikala na nzoto ya P.E Lumumba	justice
VOA60 Lingala 23 f^vrier 2021	bokengi / securite
VOA60 Lingala 6 mai 2021	bokengi / securite
VOA60 Lingala 11 janvier 2021	politiki / politique
Bopesi mangwele ya COVID-19 bobandi na Nord-Kivu (Gouv. Carly Nzanzu)	bokolongono / santé / medecine
VOA60 Lingala 10 juillet 2020	politiki / politique
Trump na Melania bandimi ete bazwami na COVID-19 mpe bamikotisi ndako	bokolongono / santé / medecine
Ba témoins babengisami le 3 juin na bosambisami ya Kamerhe, Jamal na Muhima	justice
"Mokambi ya batomboki ""Raïa Mutomboki"" Koko-di-Koko asambisami na Bukavu"	rdc
Basango ya le 15 avril 2019 na 16h TU na VOA Lingala	rdc
Ministre Longondo alobi sango ya kosomba bibembe mpo na COVID19 eza lokuta	bokolongono / santé / medecine
VOA60 Lingala 18 avril 2020	bokengi / securite
Bitakwira ya FCC alobi ntango ya kolobela bozongi ya Kabila ekoti nanu te	rdc
Sassou alobi milona mikozala likonzi ya bokonzi bwa ye	politiki / politique
Bato motoba bakufi na attaques mibale na Mambisa	rdc
Pene na bakangami 50 bazoki na bomeki kokima boloko ya Buluwo na Haut-Katanga	bokengi / securite
Ba officiers 8 bakangami na Beni mpo na bobomi na bato na mobulu ya Kamuina Nsapu na Kasaï	justice
Pentagone ekati malakisi ya basoda ya Mali mpo baike bazali na bokweyisi bokonzi ya IBK	bokengi / securite
Moto ya mibale azwami mpe akufi na Ebola na Beni	bokolongono / santé / medecine
Pompeo alaki boleki na bopete na mandat ya mibale ya Trump	politiki / politique
Ba réseaux sociaux mpe messageries ekangami yambo na maponami na Ouganda	politiki / politique
Police etindiki baye ya Lamuka liboso ya Cour constitutionnelle	rdc
CLC elaki botelemeli mosusu soki bakonzi bayoki te	rdc
Police epanzaki bato batambolaki nzinganzinga na Bemba mpo na koboya Malonda	politiki / politique
Sango ya le 25 avril 2019 na 16h TU na VOA Lingala	rdc
VOA60 Lingala 5 avril 2021	politiki / politique
COVID19 : Sassou aboyi kobimisa Mokoko na Okombi babima na boloko	justice
Motango ya bawei mokomi 15 nsima na likama ya By-pass na Kinshasa	rdc
Police ebeti masasi na Sit-in ya basali ya bitumba na Ebola na Mbandaka	bokolongono / santé / medecine
Yali 2019 : G. Bitomwa alobeli tourisme na RDC mpe Z. Muteba, business na bilona	rdc
Nini elekaki na zando monene ya Kinshasa? (Vidéo)	bokengi / securite
"Washington elaki kosunga ""opération Barkhane"" ata Paris esukisi yango"	bokengi / securite
Greenpeace esengi lisusu Tshisekedi koboya misala ya pétrole na parc ya Salonga	rdc
Tshisekedi alaki kopesa basimba minduki misala mya bilanga soki batiki bitumba, na Sake	bokengi / securite
Uhuru Kenyatta andimi kotinda basoda ba ye kosunga FARDC na bitumba na badongolomeso	bokengi / securite
Moko na ba avocats ya babanyamulenge ayanoli mpo etali milice Gumino	rdc
VP ya kala ya Zambie Nevers Mumba alobi ayebi ntina bakangeli ye te na Lumbubashi [TOYOKA]	politiki / politique
Moyi mboka Canada atikami na bokangami ya ba Maï Maï na Maniema	rdc
Nini mpela ezali kosala na Kinshasa?	rdc
Bato baiike bazongeli mosala na Rwanda	bokolongono / santé / medecine
Trump aboyi kotatola liboso na Sénat, kolanda mopesi toli na ye	justice
VOA60 Lingala 7 novembre 2020	politiki / politique
Ba Sénateurs bakozanga mpifo likolo na bofundami ya kaniaka, ekebisi Licoco	rdc
VOA120 Lingala 27 juin 2020	justice
Coronavirus : OMS esengi bato babanga te kasi basalela bopeto	bokolongono / santé / medecine
Kimya ezongi na Paris nsima na mobulu mpo na mindule ya Fally Ipupa	rdc
Assemblée nationale endimi Ronsard Malonda lokola mokambi ya CENI ya sika	politiki / politique
Volcan Nyiragono: Mokambi ya soda lieut.gén. Ndima asengi na bavandi ya Goma kolanda maloko na kimya	bokengi / securite
Tshisekedi na Brazzaville	politiki / politique
Ba historiens balakisi France mosapi na mpo na génocide ya Rwanda	bokengi / securite
VOA60 Lingala 4 novembre 2020	politiki / politique
Sango ya le 8 avril 2019 na VOA Lingala	rdc
Bayi LUCHA mwambe bakatelami mikolo 15 ya boloko na Kalehe	rdc
Tshisekedi akutani na Museveni na Kampala	rdc
VOA60 Lingala 25 mai 2021	bokengi / securite
VOA60 Lingala 24 octobre 2020	politiki / politique
Franck Diongo aboyi bilongi ya F. Tshisekedi na Kabila na lokasa ya mbongo	rdc
VOA60 Lingalal 10 juin 2020	politiki / politique
Tshisekedi asengi bana ba kelasi ba Beni kotika kolala libanda mpe alaki eyano ya bokengi	bokengi / securite
Bayi Beni basengi bosembo na bokundamii bwa F. Kambale ya LUCHA policier abomaki na masasi	bokengi / securite
Mokambi ya diplomatie ya France azelami na Kinshasa le 20 mai	rdc
40 Congolais ya yambo ya baye bakangamaki libanda bazongisami	bokolongono / santé / medecine
Koko ya P.E. Lumumba apesi eyano na mokano ya justice belge ya kozongisa linu na ye	justice
NOGEC ememi botiyami ya Kyungu na SNCC na Yuma na Gécamies na Conseil d’Etat	rdc
"Félix Tshisekedi alobi ""2020 ezali mobu ya mosala"" na lisikulu liboso ya Congrès"	rdc
Policier abomi moko na bayi LUCHA na Beni, USA esengi etumbu	bokengi / securite
Ndimbola ya bakambi batiami na Gentiny Ngobila na mobulu na Lopitalo lonene ex-Mama Yemo	bokolongono / santé / medecine
Mosambeli ya français ya Vital Kamerhe alobi RDC eboyi kopesa ye visa mpo na procès	justice
"Tshisekedi na ba Congolais na Bruxelles: ""Tokozwa na maboko boteki mpe misolo ya ba mines na biso"""	rdc
Zoé Kabila akweyisami bo' mokambi ya etuka na Assemblée provinciale ya Tanganyika	politiki / politique
Ba ADF babomi lisusu na Beni	bokengi / securite
FARDC elobi mampinga ya bikolo nzinganzinga makoya te kobengana banguna mabele ya Congo	rdc
Koleka bato 14 bakufi na bitumba ya BDK na Kongo central	bokengi / securite
Boponi ya Baponi banene bondimisi elonga ya Joe Biden	politiki / politique
"Ambassade ya USA ebandi ""défi"" ya kolata masque"	rdc
Ministre ya Yambo asengi balendela bazuzi baye batindaki bokangami ya VPM Tunda	politiki / politique
Député Muhindo Kasekwa asi akebisaki mpo etali Obsevatoire volcanique ya Goma	bokengi / securite
VOA60 Lingala 8 décembre 2020	politiki / politique
VOA60 Lingala 10 novembre 2020	politiki / politique
Etumbu ya mibu 20 esengami mpo na évêque Mukuna	justice
Bato 36 bazo'monana te nsima na bozindi ya baleinière na Maluku (Kinshasa)	rdc
Cardinal Ambongo akebisi bayi politiki kosepela na mpasi ya bana mboka	rdc
Dr. Mukwege alobi botiami ya TPI bokosilisa mobulu na mboka	politiki / politique
Matanga ya Guy-Brice Parfait Kolelas na Brazzaville [TOTALA]	politiki / politique
Biden alaki na Macron kozongisa boyokani makasi na OTAN na UE	politiki / politique
Nzoto ya bato bawei 24 ezwami nsima na bomati ya mayi na Uvira	bokengi / securite
Mobulu kati mpe libanga ya Assemblée nationale	politiki / politique
Baloni mpe babokoli bibwele baz’o tia makanisi esika moko na Walungu (Sud-Kivu)	rdc
VOA60 Lingala 15 mars 2021	politiki / politique
Ba civili 34 bakufi na maboko ya basimba minduki na mposo mibale na Est ya RDC	bokengi / securite
VOA60 Lingala 30 mai 2020	rdc
Rwandais JB Ruberwa alongi étape ya liboso ya tour international ya RDC	rdc
Mokambi ya DEMIAP général Delphin Kahimbi akufi	rdc
Bakeli mibeko 391 bakoti Union sacrée, kolanda bilembo Bahati apesi Tshisekedi	politiki / politique
VOA60 Lingala 21 novembre 2020	politiki / politique
VOA60 Lingala 5 octobre	politiki / politique
VOA60 Lingala 19 avril 2021	bokolongono / santé / medecine
VOA60 Lingala 13 juillet 2020	politiki / politique
Couvre-feu na RDC mpo na kobetela ekolo na mbonge ya mibale ya COVID-19	bokolongono / santé / medecine
Evariste Ndayishimiye akolapa ndayi mpe akozwa bokonzi le 18 juin na Burundi	politiki / politique
Bato batelemelaki maloba ma Kagame na milulu na Bukavu	politiki / politique
Kahimbi, Tango Four mpe John Numbi bazali kopekisa USA kosunga FARDC malamu (P. Pham)	rdc
VOa60 Lingala 23 septembre 2020	politiki / politique
Bato 41 bazwami na COVID19 na boloko ya N'Dolo	bokolongono / santé / medecine
Biyano bya Tshisekedi na Charles Michel na bapanzi sango na Kinshasa	bokengi / securite
"Ntaganda ""Terminator"" azwi etumbu ya mibu tuku misato ya boloko (Bilili)"	rdc
VOA60 Lingala 3 décembre 2020	politiki / politique
Police ekangi bato 23 kati na baye bazalaki kolanda malakisi ma basoda na Kingabwa	bokengi / securite
CACH-FCC balaki kosakola boyokani ya gouvernement lelo	rdc
VOA60 Lingala 13 mars 2020	rdc
VOA60 Lingala 10 juin 2021	politiki / politique
Ambassadeur “Koko” Swing ya kala ya USA akufi na mibu 86	politiki / politique
COVID-19: Président ya Burkina Faso apesi sanza motoba ya lifuta na ye	bokolongono / santé / medecine
Pelosi alobi esengeli kolongola Donald Trump	politiki / politique
Bato 13 bakufi na likama lya motuka na Kabeya Kamwanga	bokengi / securite
Philipe II akokende lisusu te na RDC mpo na mibu 61 ya lipanda	politiki / politique
Bakonzi ya Kinshasa bakebisi bato bakolanda malako ya komibatela te na COVID19	bokolongono / santé / medecine
Santé	bokolongono / santé / medecine
VOA60 Lingala 10 février 2021	justice
Ministre wa yambo Ilunga akweyisami na motion ya censure ya Assemblée nationale	politiki / politique
14 mai 2002 – 14 mai 2020 : Mibu wuto ba mampinga ya Rwanda mabomaki bato na Kisangani	bokengi / securite
Bilili ya liwa ya mokambi ya clinique Vijana na masasi na Kinshasa	rdc
Audience ya mibale ya bosambisami ya bozongeli ya Kamerhe le 21 août	justice
Ibenge alobi ba Léopards bakolakisa bokasi na Zimbabwe	rdc
Mpepo ya ba soda ezwi likama na bokiti na Goma	rdc
Boloko ya libela bosengami mpo na mokambiya ya Raïa Mutomboki Koko-di-Koko	rdc
Yannick Bolasie akozala te na CAN 2019	rdc
Monusco eboyi likambo ya balkanisation	rdc
Pompeo apesi Tshisekedi longonya mpo na bosambisami ya Kamerhe	justice
Moko na bakambi ya ba Kamuina Nsapu akangami na Luebo	rdc
Lisikulu na Congrès: Sassou alaki maponami ma mokonzi ya mboka le 23 mars	politiki / politique
Moto moko akufi na masasi na milulu ya koetelemela MONUSCO na Butembo	bokengi / securite
Basoda ya Monusco bakoki kobanda kolongwa na 2022	rdc
VOA60 Lingala 7 décembre 2020	politiki / politique
VOA60 Lingala 31 décembre 2020	politiki / politique
Masque ekomi lotomo na Kinshasa, Gombe ekobanda kofungwama lundi	bokolongono / santé / medecine
"""Conditions météorologiques"" mpe ""dépréssurisation"" nde ntina ya bokweyi ya Antonov 72, elobi J. Makele"	bokengi / securite
Bakangami 13 bakimi boloko bwa Irumu	bokengi / securite
RDC, Rwanda, Burundi, Tanzanie mpe Ouganda na bokutani ya bokengi na Goma	rdc
Poutine ayambi F. Tshisekedi na molongani wa ye D. Nyakeru (bilili)	rdc
Dr. Muyembe atangami kati na bato 100 baye baleki na mpifo na mokili na 2020	bokolongono / santé / medecine
Ruberwa asengi ngonga 48 mpo na koyanola mituna ya bakeli mibeko mpo na Minembwe	politiki / politique
Ministre ya kala Willy Bakonga akangami na Brazzaville	bokengi / securite
Mbulamatari ya Sama Lukonde endimami na Assemblée nationale	politiki / politique
Katumbi atelemeli bozangi bokengi na Beni	politiki / politique
Bosambisami bwa Kamerhe botindikami le 7 août	justice
VOA60 Lingala 29 mai 2021	bokengi / securite
Mokambi ya SCPT atiami na bokangami	justice
Sassou asololi mpo na misala mya Kimya na RDC mpe CIRGL na motindami mwa Guterres Huang Xia	bokengi / securite
VOA60 Lingala 27 novembre 2020	politiki / politique
VOA60 Lingala 15 juin 2020	politiki / politique
VOA60 Lingala 6 juillet 2020	politiki / politique
Pene na nzoto 29 ezwami nsima na likama ya mpepo na Goma (Vidéo)	rdc
Bavocats bapameli bolayi ya ntango na bosambisami ya ba experts ya ONU	rdc
Bato 11 bakufi na bokoti ya Bakatanga Katanga na Lubumbashi [TOTALA]	bokengi / securite
Etat de siège: Ba députés nationaux babakisi mikolo 15 kasi babengisi ministre ya Défense kolimbola	bokengi / securite
"Bokono bwa mbasu to ""Ulcère de Buruli"""	bokolongono / santé / medecine
Tshisekedi, Deby, Carvalho, Touadéra mpe Bongo na bokutani ya CEEAC na Libreville	rdc
Assemblée nationale endimi rapport ya maponami Nangaa apesi	politiki / politique
Mission diplomatique ya RDC na France etelemeli bobimisi ya ambassadeur na yango na ndako	justice
VOA60 Lingala 13 mai 2021	politiki / politique
Ba FARDC babotoli Madina (Beni) na maboko ya ba ADF	rdc
Mangomba 70 ma basimba minduki mandimi kotika bitumba na Sud-Kivu	bokengi / securite
Pasteur Kabundi WaLesa asengi na Tshisekedi koyoka mpe Nzambe	politiki / politique
Bavandi ya Kinshasa bakokangama na ndako mikolo minei banda samedi (Gouverneur)	bokolongono / santé / medecine
Mokonzi ya parquet ya Rutshuru abomami mposo moko nsima na liwa lya ntoma Attanasio	bokengi / securite
VOA60 Lingala 24 avril 2021	bokengi / securite
Basoda mpe ba policiers 21 basambisami mpo kozwa na basi na makasi na Ruzizi	justice
Misala ya kotala ba recours ya ba parlementaires balongalami esili	rdc
Tshisekedi asengi na bakambi ya bituka kolanda na lotomo linaka na ye	rdc
Pene na bato 15 babomami na territoire ya Beni	rdc
Gode Mpoy atikali mokambi ya Assemblée provinciale ya Kinshasa na mokano ya ba députés	politiki / politique
COVID-19: Botinda mituna na bino nyonso	bokolongono / santé / medecine
"Mokolo mwa bakoni na molongo: Dr. Mukendi alobi bondeko mpe ""ntintsani"" ekoki kobikisa bato mingi"	bokolongono / santé / medecine
VOA60 Lingala 28 avril 2021	politiki / politique
Ibrahim Boubacar Keïta IBK mokonxi ya Mali atiki mosala (Vidéo)	politiki / politique
Bayi UNC batombolaki na Bukavu mpo na kosenga bobimisami ya Kamerhe	justice
VOA60 Lingala 21 juilet 2020	justice
Ministre wa Yambo na mbulamatari batiki mosala na Congo-Brazzaville	politiki / politique
Bato banei bakufi na botelemeli Monusco	rdc
Balandi ba Kamerhe basambeli yambo na bozongeli ya bosambisami na ye le 15 février	politiki / politique
Makobola : milulu ya bokanisi mibu 21 ya bobomami (vidéo)	rdc
Ba ADF babomi lisusu bato 12 na Beni	rdc
Amida Shatur ayonoli te na parquet, ba avocats na ye balobi azali maladi	justice
Bakeli mibeko ya FCC baboyi masolo ma mbogwana ma maponami libanda lya parlement	politiki / politique
VOA60 Lingala 25 septembre 2020	politiki / politique
Bato 22 bakufi na likama ya motuka na na Manono	rdc
Bato 42 bakufi na likama lya motuka na Masamuna na Kwilu (Dumalegi Lumeya)	bokengi / securite
VOA60 Lingala 8 février 2021	bokolongono / santé / medecine
Liwa lya Chebeya na Bazana: Basambeli bafundi general Djadjidja na Numbi	justice
Ba ADF babomi pene na bato 17 kati na Itrui ne Beni na mikolo mibale	bokengi / securite
Moto moko akufi na Beni, mosusu na Butembo na botelemeli Monusco	rdc
Maladi ya ndeke: kindoki to bokono lokola makono masusu?	bokolongono / santé / medecine
VOA60 19 septembre 2020	politiki / politique
Tribunal eboyi lisusu kobimisa Kamerhe	justice
VOA60 Lingala 16 juillet 2020	justice
Zuzi Yanyi akufaki na traumatisme crânien	justice
VOA60 Lingala 16 mai 2020	bokolongono / santé / medecine
Mokonzi ya ba FARDL/F S. Mudacumura akufi na bitumba na mampinga ya FARDC	rdc
Ne Muanda Nsemi abimi CNPP mpe azongi ndako	politiki / politique
Fayulu asengi bakambi na biyamba komema boyokani mpo na kosilisa matata na mboka	politiki / politique
PM Ilunga apesi FCC na CACH ba critères ya baye bakozala na gouvernement	rdc
Couvre-feu ebakisami mikolo na Brazzaville na Pointe-Noire	bokolongono / santé / medecine
Mboso asengi na bakeli mibeko kobimba na mangomba ya basimba minduki	bokengi / securite
Fidèle Babala ayanoli nsima na bolongwi ya ba députés ya opposition	rdc
Grève ya basali ya bitumba na Ebola na Mangina	bokolongono / santé / medecine
Bintou Keita alobi mobulu mozali na ntina te mpo MONUSCO esi' ebandaki na mabongisi ya kolongwa	bokengi / securite
VOA60 Lingala 22 avril 2021	politiki / politique
Urgences na lopitalo ya Kyeshero na Goma	bokolongono / santé / medecine
VOA60 Lingala 31 mars 2020	rdc
Kabila na Kolwezi [TOTALA]	politiki / politique
Bitumba ya FCC na Union Sacrée mpo na bolongwi ya PM na ya Bureau d’âge ya Assemblée nat.	politiki / politique
Etumbu ya mibu 2 kino 5 ya misala makasi na bato 29 basalaki mobulu na ramadan na Kinshasa	justice
Ngobila azwi bokambi ya Commission spéciale ya boyokani kati na Brazzaville na Kinshasa	politiki / politique
Ba 13 basengi maponami le 24 to le 27 2023 na mokanda bapesi Tshisekedi	politiki / politique
Bato 13 bakufi na bobukani ya mabele na Masisi, Nord-Kivu	rdc
Bitumba bingali na Assemblée nationale kasi ministre ya Fonction publique atelemisi misala mya SG	politiki / politique
MLC eza komilengele mpo na kofunda lolenge CACH na FCC bazali kobunda mpo na kotia bazuzi bakosalela bango	politiki / politique
Madeleine Malonga akomi elombe ya molongo ya Judo	rdc
Bakima bitumba ya Kamwina Nsapu bazali kozonga kowuta Angola	rdc
COVID-19: Policier moko abomi civil mpe azokisi mosusu na masasi mpo na masque	bokolongono / santé / medecine
Esengo ya baike na blvd Lumumba nsima na bokweyisami ya Mabunda	politiki / politique
Fayulu asambeli na bana bitike na Beni	rdc
Etat de siège: Washington esepeli te na botiami ya bakambi bafundama mpo na mbeba ya bomoto	bokengi / securite
Bayi politiki bazalaki na nsima ya bobomani ya Yumbi, elobi Mme Mushobekwa	rdc
Goma na Rutshuru etiami na bokangami mpo na COVID19	bokolongono / santé / medecine
"Mubake alobeli nini akanisi na mbela mpo na ""Union Sacrée"" [TOTALA]"	politiki / politique
Ndenge bato bayambi mangwele ma COVID-19 na RDC	bokolongono / santé / medecine
Bakambi ya maponami balobi moyibi momonisami te na boponi mokonzi ya Amerika	politiki / politique
Patrick Muyaya alimboli mpo na nini mbulamatari ebimisi bavandi baike na Goma	bokengi / securite
Moto moko atekaki ntoma Attanasio na babomi, elobi molongani wa ye	bokengi / securite
VOA60 Lingala 5 mars 2021	politiki / politique
Katumbi na Kinshasa vendredi mpo na kokutana na Tshisekedi	politiki / politique
Ministre Nene Nkulu mpe ministre Kitobo bapekisami kozwa mpepo ya kokende na bituka	politiki / politique
Litatoli ya mwasi moko abiki na bitumba ya ba ADF/Etat islamique na Beni	rdc
Tshisekedi alobi nyonso asali epsaki te nzela ete libala CACH-FCC litambola malamu [TOTALA]	politiki / politique
Sango ya le 10 juin 2019 na VOA Lingala	rdc
Museveni alapi ndayi mpo na kotikala na ebonga na ya mokonzi mbala ya motoba	politiki / politique
"USA ekebisi na ba ""attaques"" ya badongolemeso na Noël na Beni"	bokengi / securite
Bato libwa bakufi na bitumba kati na ba Maï Maï na ba FARDC na Butembo	rdc
Volcan Nyiragongo: Lieut.Gén. Ndima asengi na bavandi ya Goma kokende Kibumba mpo Sake etondi bato	bokengi / securite
Basoda baye bazwi bokonzi na Mali balaki kosalisa maponami na lombango	bokengi / securite
VOA Lingala 10 mai 2020	justice
Honoré Ngbanda akufi na mibu 74 na Maroc	bokengi / securite
Tshisekedi apesi losako na bawei ya génocide na Rwanda	rdc
Jacques Chirac, mokonzi ya kala ya France, akufi	rdc
Mbela ya gouverneur Ngobila na bana ya Kin mpo na COVID-19	bokolongono / santé / medecine
Pene na bato 15 babomami na baye fundami kozala ba ADF na Bulongo na Beni	bokengi / securite
Moto moko azwi masasi mpe ba démocrates bapameli Coup d’Etat ya balandi ya Trump	politiki / politique
DG ya SOCOC akangami na Goma	justice
Liwa lya Chebeya: Alain Longwa andimi kokende kolakisa esika nzoto ya Bazana ekundamaki na Mitendi	politiki / politique
Cardinal Ambongo akebisi mpo na lolenge ya kosalela mikano ya COVID-19	rdc
ONU elaki lisungi na Sassou na boluki kimya na RDC, na Gds Lacs, Libye mpe Centrafrique	politiki / politique
Reportage na bililingi bya ndenge Bakata Katanga bakotaki mpe basukisami na Lubumbashi	bokengi / securite
Bato 24 babomami na baye bafundami kozala ba ADF pene na Oicha	rdc
VOA60 Lingala 9 novembre 2020	politiki / politique
Alanga nzembo Idinco Delcat atikami kasi alaki kokoba bitumba bya ye na Beni [TOTALA]	justice
Na bozangi bokebi bana ya Congo bakozwa mbano te na Inga III (Ba ONG)	rdc
VOA60 Lingala 27 février 2020	rdc
"""Empeachment"" : Ba procureurs démocrates balobi Trump atindaki eyoma ya le 6 janvier"	politiki / politique
Ndenge nini bato baponaki mokozi na Etats-Unis [TOTALA]	politiki / politique
Banque mondiale elaki Tshisekedi kofungola ba bureaux na Goma na Kananga mpe kobakisa misolo	rdc
"""Health Malamu"": ekela ya elenge Guylain Badesi mpo na mbongwana elamu na kopesa lisungi na babeli"	bokolongono / santé / medecine
Bayike na bavandi ya Beni batumbi Mairie mpe base ya Monusco	rdc
Mike Hammer na ba ntoma misusu basengi bayi politiki koboya mobulu mpe kosimba libaku lya mbongwana	politiki / politique
Kabund akebisi kosukisa boyokani na FCC soki batosi Tshisekedi te	rdc
"Bobomi ya Chebeya ba Bazana: Général ""Djadjidja"" akangami"	justice
Etumbu ebandi na liwa kino mibu 12 ya boloko esengami mpo na bakangami na koyiba bacornières ya SNEL	justice
Bokono ya makwanza boyebani malamu te bozali kobangisa na Goma	bokolongono / santé / medecine
Pene na nzoto ya bato 35 babomami na ADF ezwami na Tsabi	bokengi / securite
Gouvernement esengi Ne Mwanda Nsemi kozonga na boloko	rdc
Congrès epesi Sassou ndingisa ya kobakisa mikolo 20 na Etat d’urgence	bokolongono / santé / medecine
Eyano ya mbulamatati ya Kinshasa na ndenge Washington ebengi ba ADF Etat islamique ba dongolo meso	bokengi / securite
Gentiny Ngobila apekisi ba Shegués kosenga mbongo na nzela (Interview)	rdc
Policier moko akufi mpe mosusu azoki nsima moto moko kotambola likolo bango na motuka na Capitole	bokengi / securite
Concertation politique (boyokani) ebandi na Congo-Brazzaville	politiki / politique
Ouganda na RDC batie manzaka na boyokani mpo na botongami ya ba nzela mpe bokengi na Congo	bokengi / securite
Mibu 39 ya UDPS: Kabund asengi lisanga soki te lingomba likobungisa bokonzi	politiki / politique
Katumbi liboso ya bituluku na Kindu	rdc
Sango ya le 9 août 2019 na 16h TU na VOA Lingala	rdc
Budget ya COVID-19 kino sika ezali ya 135 millions $ (Dr. Muyembe)	bokolongono / santé / medecine
Biden atindeli Tshisekedi mokanda ya mokakoswa mpo na bokambi bwa ye na UA	politiki / politique
Session extraordinaire ya Assemblée provinciale ya Kinshasa ekozala te mpo na COVID-19 (Godé Mpoy)	politiki / politique
Ba Américains babini mindule ya Congo na festival PanaFest na Silver Spring (Maryland)	rdc
Ba CTE etongamaki mpo na Ebola ekomi nini na Beni?	bokolongono / santé / medecine
Bitumba kati na UDPS na PPRD na Kinshasa	politiki / politique
Sassou abengisi boponi na maponami ma mokonzi ya mboka le 21 mars	politiki / politique
Dr. Oly Ilunga atindami na Cour ya cassation nsima na koleka na parquet	rdc
VOA60 Lingala 16 janvier 2020	politiki / politique
Tshisekedi aza na Davos, abengisi PM ya Belgique na février	rdc
Bopesi manwela ya Ebola bozali kokende malamu na Equateur (Ministre)	bokolongono / santé / medecine
VOA60 Lingala 11 août 2020	bokengi / securite
Tshisekedi na Macron bapameli bonyati bato bazali kotelemela na Tchad	bokengi / securite
Félix Tshisekedi azali na Lusaka	rdc
Ministre ya Sembo apesi ndingisa na bolukiluki mbeba na maponami na USA	politiki / politique
Lucien-Réné Likulia apesami pete ya lieut-gén. mpe ebonga ya auditeur gén. ya mampinga	justice
RDC elongwe na Coupe du monde ya Handball ya basi	rdc
Ne Mwanda Nsemi alobi ayei kosala na bokonzi ya sika	rdc
Kenneth Kaunda mokonzi ya kala ya Zambie akoti lopitalo	bokolongono / santé / medecine
Tshisekedi asengi lisungi ya Washigton mpo na kokyeyisa système dictatorial	rdc
Antoine Kesia-Mbe Mindua ya RDC aponami vice-président ya mibale ya CPI	justice
Justice ya France ezongeli dossier ya baye balukaki koboma colonel Mbau chef ya garde présidentielle ya Lissouba	justice
Bato 13 bakufi na bitumba kati na Baluba na Bakuba na Bakwakenge (Kasaï)	bokengi / securite
Nzoto 20 ezwami nsima likama na mayi ya Kasaï	rdc
Mangwele ma COVID-19 makobanda kopesama le 12 mars na RDC	bokolongono / santé / medecine
SG ya Assemblée nationale abengisi likita mardi nsima na Mabunda kotelemi misala minso	politiki / politique
Mokambi ya bitumba na COVID-19 mpe ministre ya bokolongomo bazwi mangwele	politiki / politique
VOA60 Lingala 7 janvier 2021	politiki / politique
Ndako ebele eziki na moto makasi na Bukavu	rdc
"Sassou abengisi Tshisekedi na ""Forum Investir en Afrique"" na Brazzaville"	rdc
Bato basato bakufi na botelemeli ya bavandi na ba exploitants miniers na Sakanya	rdc
VOA60 Lingala 6 octobre 2020	bokolongono / santé / medecine
3e vague ya COVID-19: Ngobila abwaki mbela ya bokebi na bavandi ya Kinshasa	bokolongono / santé / medecine
Tshisekedi alobeli kimya, Ebola mpe bozongi na bilanga na Beni	rdc
Moto moko akufi nsima na botamboli ya le 30 juin, etatoli HRW	rdc
VOA60 Lingala 14 juin 2021	politiki / politique
"E. Ramazani na ba ministres : ""'grand prètre' aza kaka moko, président Kabila"""	rdc
VOA60 Lingala 25 avril 2020	bokolongono / santé / medecine
Théodore Ngoy alobi Tshisekedi alaki kosolola na bayi FCC mpo na kotosa Buku Likonzi [TOTALA]	politiki / politique
VOA60 Lingala 1er septembre 2020	bokengi / securite
ONU ezangi mosolo mpo RDC, USA mpe mboka mingi bafuti oyo basengelaki te	rdc
Cour constitutionnelle etiki kaka ba candidats sambo mpo na kowelela présidentielle ya mars na Congo	politiki / politique
Tshisekedi afungoli Eteyelo ya Bitumba ya Kinshasa	bokengi / securite
"Tshala Muana alobi akosala recours mpo na nzembo na ye ""Ingratitude"" [TOTALA]"	politiki / politique
Tshisekedi asengi bakambi ya biyamba komikotisa na biutmba na COVID-19	bokolongono / santé / medecine
Mikolo boni Kamerhe akowumela na boloko? Eyano na Me Kapiamba	justice
VOA60 16 novembre 2020	politiki / politique
Kabila azalaki na bokutani ya FCC na Kisantu	rdc
Bofungolami ya Gombe bokobanda moke moke lundi	bokolongono / santé / medecine
Bakambi ba biyamba bandimi te kotambwisa libenga lya COVID19	bokolongono / santé / medecine
L.D. Kabila, mibu 19 mileki	rdc
VOA60 Lingala 30 janvier 2021	politiki / politique
Lugi Gizenga akufi	politiki / politique
Bakeli mibeko ya Ituri balekisi motion ya défiance mpo na kolongola Bamanisa	rdc
Pene na bato 21.000 bakimi bitumba kati na Bakuba na Baluba Kasaï	bokengi / securite
Ba réfugiés ya RDC bazali kosenga HCR kotinda bango mboka esusu na Cap (Afrique du Sud)	rdc
Ilunga Ilunkamba andimi kolongwa kasi azozela mokanda ya Bureau d’âge	politiki / politique
Kitenge Yesu awei na mibu 77	politiki / politique
Moto moko amonani na Ebola ne Beni	bokolongono / santé / medecine
Sango ya le 2 août 2019 na VOA Lingala	rdc
Evêque Mukuna akobanda kosamba vendredi na Makala	justice
VOA60 Lingala 25 novembre 2020	politiki / politique
Zuzi Kaluba aponami mokambi ya Cour constitutionnelle	justice
Pene na bato nkama bazwami na COVID-19 na boloko ya N'Dolo	bokolongono / santé / medecine
Sassou asengi bakonzi ba bikolo bya CEEAC kosunga transition ya basoda na Tchad	politiki / politique
ACAJ esengi balandela bakonzi ya kala na ya sika mpo batalisa bozwi na bango	rdc
"Dr. Munyangi : ""president Tshisekedi andimi kopesa maboko mpo na tosala nkisi ewuti na Congo"""	bokolongono / santé / medecine
Sango ya le 12 juillet 2019 na 16 TU	rdc
Mibu 20 ya misala makasi mikatelami na Inspecteur général ya ESPT mpe na mokambi ya SECOPE	justice
Monganga moko akufi na attaque na clinique universitaire Graben na Butembo	rdc
Lingomba Etat Islamique elobi ebomi basoda mitano ya MONUSCO kasi ONU endimi kaka moko	bokengi / securite
PM Ilunga atombokeli Tshisekedi mpo Kankonde atiaki manzaka na esika na ye na mikano	politiki / politique
Fayulu asengi Washington ekende mosika koleka etumbu likolo ya CENI	rdc
Cardinal Ambongo asengi mbongwana ebima na boyoki bato Tshisekedi azali kosala	politiki / politique
Etats-Unis epesi ndingisa bakoni ba Ebola basalisama na ba anti-corps ya synthèse emekamaki na RDC	bokolongono / santé / medecine
Basango ya le 3 avril 2019 na 16h TU na VOA Lingala	rdc
Ministre ya Intérieur ya Sud-Kivu alobi Ruberwa nde atindaki milulu mya Minembwe	politiki / politique
Ba policiers basatu bakufi na bobetami na masasi na lopitalo ya Camp Lufungula (Kinshasa)	rdc
VOA60 Lingala 9 janvier 2021	politiki / politique
